ticks,turtles,healthy turtles,exposed turtles,infected turtles,immune turtles,masked turtles
0,1500,1490,10,0,0,1500
1,1500,1490,10,0,0,1500
2,1500,1490,10,0,0,1500
3,1500,1483,7,10,0,1500
4,1500,1474,16,10,0,1500
5,1500,1466,24,10,0,1500
6,1500,1456,28,16,0,1500
7,1500,1439,42,19,0,1500
8,1500,1429,43,28,0,1500
9,1500,1394,66,40,0,1500
10,1500,1360,88,52,0,1500
11,1500,1329,108,63,0,1500
12,1500,1286,126,88,0,1500
13,1500,1225,154,121,0,1500
14,1500,1140,210,150,0,1500
15,1500,1062,245,193,0,1500
16,1500,992,275,233,0,1500
17,1499,901,293,298,7,1499
18,1500,788,323,382,7,1500
19,1500,667,373,453,7,1500
20,1498,571,386,531,10,1498
21,1500,481,368,641,10,1500
22,1499,393,355,736,15,1499
23,1498,313,321,843,21,1498
24,1494,232,309,927,26,1494
25,1497,175,289,1001,32,1497
26,1486,133,234,1076,43,1486
27,1475,96,203,1115,61,1475
28,1455,80,149,1157,69,1455
29,1429,68,94,1183,84,1429
30,1411,53,76,1176,106,1411
31,1375,38,56,1139,142,1375
32,1346,32,51,1069,194,1346
33,1314,21,48,1014,231,1314
34,1267,17,39,945,266,1267
35,1214,15,30,847,322,1214
36,1167,14,28,752,373,1167
37,1121,16,20,645,440,1121
38,1074,19,17,555,483,1074
39,1041,23,14,476,528,1041
40,1000,22,14,382,582,1000
41,981,31,15,313,622,981
42,956,39,13,245,659,956
43,928,41,11,183,693,928
44,917,45,8,153,711,917
45,906,48,8,117,733,906
46,908,54,7,105,742,908
47,909,56,7,93,753,909
48,908,62,8,79,759,908
49,911,71,9,65,766,911
50,909,75,9,58,767,909
51,908,80,7,50,771,908
52,914,87,6,46,775,914
53,920,94,9,41,776,920
54,925,101,7,39,778,925
55,930,104,12,36,778,930
56,938,112,11,35,780,938
57,947,120,9,33,785,947
58,952,125,8,31,788,952
59,958,130,5,34,789,958
60,966,137,7,32,790,966
61,974,146,6,30,792,974
62,979,148,6,32,793,979
63,989,159,6,31,793,989
64,998,166,8,31,793,998
65,998,163,10,29,796,998
66,1006,171,10,29,796,1006
67,1012,174,12,29,797,1012
68,1019,184,7,30,798,1019
69,1030,193,6,33,798,1030
70,1037,198,9,32,798,1037
71,1048,206,10,31,801,1048
72,1055,211,11,30,803,1055
73,1065,220,13,27,805,1065
74,1074,225,11,33,805,1074
75,1085,234,12,34,805,1085
76,1097,243,14,32,808,1097
77,1113,258,11,36,808,1113
78,1125,268,9,39,809,1125
79,1141,282,10,40,809,1141
80,1150,288,12,40,810,1150
81,1160,291,16,42,811,1160
82,1174,300,20,40,814,1174
83,1188,309,21,41,817,1188
84,1197,310,25,44,818,1197
85,1207,317,23,48,819,1207
86,1224,324,24,56,820,1224
87,1229,325,25,58,821,1229
88,1242,330,28,59,825,1242
89,1252,334,28,64,826,1252
90,1262,328,38,69,827,1262
91,1279,337,40,74,828,1279
92,1287,333,46,78,830,1287
93,1290,323,49,86,832,1290
94,1299,318,50,99,832,1299
95,1308,318,46,111,833,1308
96,1317,309,56,117,835,1317
97,1324,303,50,133,838,1324
98,1336,298,61,137,840,1336
99,1342,289,66,143,844,1342
100,1350,282,66,154,848,1350
101,1361,287,61,163,850,1361
102,1373,279,61,179,854,1373
103,1380,265,72,185,858,1380
104,1394,264,74,197,859,1394
105,1399,249,76,208,866,1399
106,1412,243,80,216,873,1412
107,1423,233,83,228,879,1423
108,1428,224,82,235,887,1428
109,1434,208,88,244,894,1434
110,1448,201,88,257,902,1448
111,1447,201,76,260,910,1447
112,1457,192,76,275,914,1457
113,1462,176,81,287,918,1462
114,1464,164,82,288,930,1464
115,1473,157,87,291,938,1473
116,1477,135,95,296,951,1477
117,1480,127,90,302,961,1480
118,1484,127,78,309,970,1484
119,1486,123,64,319,980,1486
120,1493,120,54,327,992,1493
121,1494,109,59,319,1007,1494
122,1489,102,59,310,1018,1489
123,1488,98,55,305,1030,1488
124,1496,96,55,299,1046,1496
125,1499,96,56,290,1057,1499
126,1496,96,50,283,1067,1496
127,1495,91,51,274,1079,1495
128,1496,90,45,268,1093,1496
129,1500,83,51,263,1103,1500
130,1492,78,47,250,1117,1492
131,1495,80,42,244,1129,1495
132,1497,86,38,233,1140,1497
133,1493,94,30,215,1154,1493
134,1489,92,30,201,1166,1489
135,1500,92,35,197,1176,1500
136,1500,88,37,191,1184,1500
137,1500,92,42,178,1188,1500
138,1496,88,40,171,1197,1496
139,1499,87,36,170,1206,1499
140,1497,89,29,169,1210,1497
141,1499,92,29,160,1218,1499
142,1500,96,29,153,1222,1500
143,1499,98,30,151,1220,1499
144,1500,101,30,146,1223,1500
145,1497,102,34,137,1224,1497
146,1500,115,33,132,1220,1500
147,1498,124,38,129,1207,1498
148,1498,126,36,131,1205,1498
149,1500,145,36,125,1194,1500
150,1499,160,30,133,1176,1499
151,1499,186,34,138,1141,1499
152,1499,233,36,136,1094,1499
153,1499,257,49,132,1061,1499
154,1500,285,53,126,1036,1500
155,1500,327,60,130,983,1500
156,1500,363,61,139,937,1500
157,1500,412,66,146,876,1500
158,1500,424,82,154,840,1500
159,1500,436,99,168,797,1500
160,1498,453,118,179,748,1498
161,1500,454,140,193,713,1500
162,1500,454,149,216,681,1500
163,1499,441,162,247,649,1499
164,1499,407,185,266,641,1499
165,1500,372,195,307,626,1500
166,1500,328,201,348,623,1500
167,1500,281,211,390,618,1500
168,1500,244,197,441,618,1500
169,1500,210,183,490,617,1500
170,1497,180,164,526,627,1497
171,1500,144,163,561,632,1500
172,1500,124,147,594,635,1500
173,1496,107,125,620,644,1496
174,1494,93,102,646,653,1494
175,1492,78,87,664,663,1492
176,1491,73,83,649,686,1491
177,1478,56,87,637,698,1478
178,1474,47,79,634,714,1474
179,1463,49,71,604,739,1463
180,1448,50,69,567,762,1448
181,1426,46,55,546,779,1426
182,1392,41,43,507,801,1392
183,1366,46,32,462,826,1366
184,1347,48,32,419,848,1347
185,1325,42,32,382,869,1325
186,1300,41,36,335,888,1300
187,1287,40,37,297,913,1287
188,1265,40,28,265,932,1265
189,1251,44,17,238,952,1251
190,1251,52,21,220,958,1251
191,1252,57,19,206,970,1252
192,1246,62,24,176,984,1246
193,1251,74,26,159,992,1251
194,1253,75,26,156,996,1253
195,1251,79,22,134,1016,1251
196,1254,89,20,120,1025,1254
197,1255,90,21,110,1034,1255
198,1264,99,17,108,1040,1264
199,1265,100,19,98,1048,1265
200,1274,109,16,99,1050,1274
201,1277,114,16,97,1050,1277
202,1281,124,12,91,1054,1281
203,1287,135,14,79,1059,1287
204,1294,140,15,79,1060,1294
205,1296,145,13,74,1064,1296
206,1306,154,12,77,1063,1306
207,1320,164,16,74,1066,1320
208,1326,176,13,71,1066,1326
209,1336,178,22,65,1071,1336
210,1352,195,20,64,1073,1352
211,1366,208,18,64,1076,1366
212,1372,214,21,61,1076,1372
213,1384,221,23,64,1076,1384
214,1392,226,24,63,1079,1392
215,1402,232,28,63,1079,1402
216,1414,231,36,63,1084,1414
217,1432,245,37,69,1081,1432
218,1442,255,33,74,1080,1442
219,1454,255,39,80,1080,1454
220,1462,259,35,89,1079,1462
221,1475,263,42,93,1077,1475
222,1484,265,43,100,1076,1484
223,1495,268,42,112,1073,1495
224,1500,265,48,111,1076,1500
225,1499,255,48,123,1073,1499
226,1500,247,53,130,1070,1500
227,1499,237,60,135,1067,1499
228,1499,233,63,143,1060,1499
229,1500,227,59,158,1056,1500
230,1498,214,65,165,1054,1498
231,1500,210,65,175,1050,1500
232,1499,201,68,180,1050,1499
233,1499,185,74,188,1052,1499
234,1500,187,67,199,1047,1500
235,1500,188,67,206,1039,1500
236,1496,193,56,217,1030,1496
237,1500,200,52,221,1027,1500
238,1500,192,53,234,1021,1500
239,1499,192,56,231,1020,1499
240,1499,198,58,227,1016,1499
241,1500,199,58,238,1005,1500
242,1498,199,61,238,1000,1498
243,1500,200,64,237,999,1500
244,1498,203,66,240,989,1498
245,1499,208,63,238,990,1499
246,1499,209,65,242,983,1499
247,1499,212,60,242,985,1499
248,1500,224,56,237,983,1500
249,1498,215,64,240,979,1498
250,1499,224,61,236,978,1499
251,1498,222,68,231,977,1498
252,1496,215,71,233,977,1496
253,1499,222,71,236,970,1499
254,1500,223,68,246,963,1500
255,1496,224,66,244,962,1496
256,1500,220,65,254,961,1500
257,1499,215,72,254,958,1499
258,1496,208,84,250,954,1496
259,1499,209,86,254,950,1499
260,1500,201,91,258,950,1500
261,1500,190,89,266,955,1500
262,1498,179,91,273,955,1498
263,1500,178,91,274,957,1500
264,1498,171,82,286,959,1498
265,1500,157,85,300,958,1500
266,1497,152,84,300,961,1497
267,1499,144,85,306,964,1499
268,1499,133,92,307,967,1499
269,1500,134,79,315,972,1500
270,1494,123,75,318,978,1494
271,1500,116,75,321,988,1500
272,1497,110,68,330,989,1497
273,1499,109,67,329,994,1499
274,1494,111,65,326,992,1494
275,1494,111,61,321,1001,1494
276,1495,115,58,311,1011,1495
277,1497,117,55,313,1012,1497
278,1491,111,58,297,1025,1491
279,1484,102,61,284,1037,1484
280,1480,98,58,280,1044,1480
281,1476,98,52,278,1048,1476
282,1474,98,53,269,1054,1474
283,1466,94,48,259,1065,1466
284,1464,108,45,246,1065,1464
285,1468,117,46,237,1068,1468
286,1480,130,44,229,1077,1480
287,1476,135,42,221,1078,1476
288,1483,145,38,214,1086,1483
289,1476,141,39,208,1088,1476
290,1478,150,44,200,1084,1478
291,1482,151,53,192,1086,1482
292,1491,156,61,188,1086,1491
293,1493,161,59,189,1084,1493
294,1497,164,60,192,1081,1497
295,1496,166,65,185,1080,1496
296,1500,182,63,194,1061,1500
297,1500,188,65,190,1057,1500
298,1499,196,62,196,1045,1499
299,1500,213,55,205,1027,1500
300,1499,229,55,206,1009,1499
301,1500,236,58,212,994,1500
302,1500,238,73,212,977,1500
303,1500,250,76,213,961,1500
304,1499,246,85,224,944,1499
305,1500,238,104,232,926,1500
306,1500,236,108,244,912,1500
307,1498,239,111,256,892,1498
308,1499,235,114,267,883,1499
309,1500,225,115,289,871,1500
310,1500,214,113,295,878,1500
311,1497,202,105,318,872,1497
312,1496,196,114,324,862,1496
313,1492,177,119,338,858,1492
314,1500,164,119,351,866,1500
315,1499,171,111,365,852,1499
316,1500,162,105,387,846,1500
317,1499,149,92,410,848,1499
318,1500,147,86,417,850,1500
319,1500,136,88,419,857,1500
320,1494,123,87,419,865,1494
321,1496,108,87,419,882,1496
322,1488,108,78,415,887,1488
323,1475,101,72,404,898,1475
324,1469,100,65,399,905,1469
325,1462,96,64,381,921,1462
326,1459,87,60,380,932,1459
327,1457,89,57,360,951,1457
328,1450,89,64,340,957,1450
329,1439,97,51,331,960,1439
330,1442,110,42,317,973,1442
331,1438,115,40,292,991,1438
332,1433,117,41,277,998,1433
333,1436,111,47,267,1011,1436
334,1438,111,51,256,1020,1438
335,1434,103,53,242,1036,1434
336,1431,110,52,229,1040,1431
337,1430,107,46,224,1053,1430
338,1435,110,49,212,1064,1435
339,1435,117,43,206,1069,1435
340,1428,117,37,198,1076,1428
341,1425,113,35,196,1081,1425
342,1442,122,43,195,1082,1442
343,1447,133,43,180,1091,1447
344,1446,131,46,174,1095,1446
345,1456,138,45,172,1101,1456
346,1466,142,49,171,1104,1466
347,1476,147,43,176,1110,1476
348,1482,148,43,177,1114,1482
349,1485,142,50,175,1118,1485
350,1495,142,54,176,1123,1495
351,1499,143,62,166,1128,1499
352,1500,146,51,174,1129,1500
353,1500,147,47,177,1129,1500
354,1499,145,44,180,1130,1499
355,1499,146,44,177,1132,1499
356,1500,144,46,178,1132,1500
357,1500,144,43,185,1128,1500
358,1499,147,36,186,1130,1499
359,1495,138,46,185,1126,1495
360,1500,149,43,185,1123,1500
361,1500,148,44,180,1128,1500
362,1495,143,43,181,1128,1495
363,1495,150,44,182,1119,1495
364,1500,158,45,178,1119,1500
365,1500,166,40,181,1113,1500
366,1500,165,39,180,1116,1500
367,1500,174,40,173,1113,1500
368,1496,175,43,167,1111,1496
369,1500,181,44,163,1112,1500
370,1500,189,38,170,1103,1500
371,1499,199,35,169,1096,1499
372,1498,204,38,164,1092,1498
373,1497,208,40,160,1089,1497
374,1499,206,44,163,1086,1499
375,1499,201,54,163,1081,1499
376,1499,203,58,156,1082,1499
377,1500,205,58,158,1079,1500
378,1497,198,52,169,1078,1497
379,1500,192,53,173,1082,1500
380,1499,191,54,169,1085,1499
381,1500,190,56,175,1079,1500
382,1499,185,64,177,1073,1499
383,1500,175,69,185,1071,1500
384,1499,177,64,186,1072,1499
385,1498,167,71,189,1071,1498
386,1500,171,56,207,1066,1500
387,1500,169,55,217,1059,1500
388,1496,160,67,214,1055,1496
389,1499,157,64,228,1050,1499
390,1499,158,70,228,1043,1499
391,1500,161,62,238,1039,1500
392,1496,160,57,237,1042,1496
393,1499,162,58,238,1041,1499
394,1500,150,66,241,1043,1500
395,1499,158,64,240,1037,1499
396,1500,166,60,242,1032,1500
397,1498,155,65,246,1032,1498
398,1497,165,63,250,1019,1497
399,1499,170,66,248,1015,1499
400,1495,176,67,237,1015,1495
401,1498,173,71,239,1015,1498
402,1500,173,68,250,1009,1500
403,1495,180,71,239,1005,1495
404,1500,182,70,249,999,1500
405,1499,180,72,249,998,1499
406,1497,182,75,249,991,1497
407,1498,180,82,242,994,1498
408,1499,181,76,255,987,1499
409,1500,163,85,264,988,1500
410,1499,161,84,266,988,1499
411,1496,153,90,269,984,1496
412,1499,145,91,276,987,1499
413,1499,144,78,288,989,1499
414,1497,137,85,290,985,1497
415,1496,133,83,294,986,1496
416,1498,131,72,301,994,1498
417,1498,135,74,303,986,1498
418,1500,128,70,311,991,1500
419,1497,123,71,308,995,1497
420,1498,127,69,302,1000,1498
421,1500,120,66,314,1000,1500
422,1496,120,66,305,1005,1496
423,1495,125,62,302,1006,1495
424,1497,118,72,299,1008,1497
425,1495,112,74,295,1014,1495
426,1495,115,68,286,1026,1495
427,1497,115,67,281,1034,1497
428,1498,117,61,286,1034,1498
429,1495,114,63,277,1041,1495
430,1490,120,68,264,1038,1490
431,1497,131,53,271,1042,1497
432,1496,129,52,265,1050,1496
433,1499,136,50,259,1054,1499
434,1497,138,54,260,1045,1497
435,1498,142,57,247,1052,1498
436,1499,141,56,248,1054,1499
437,1495,152,54,240,1049,1495
438,1500,161,50,239,1050,1500
439,1498,160,56,238,1044,1498
440,1500,156,63,236,1045,1500
441,1499,164,70,226,1039,1499
442,1494,171,69,216,1038,1494
443,1498,182,64,225,1027,1498
444,1499,175,66,233,1025,1499
445,1496,175,77,227,1017,1496
446,1494,178,76,226,1014,1494
447,1497,193,79,226,999,1497
448,1499,197,77,232,993,1499
449,1498,196,64,251,987,1498
450,1499,202,67,249,981,1499
451,1500,202,73,259,966,1500
452,1500,195,81,260,964,1500
453,1498,201,81,259,957,1498
454,1499,196,87,261,955,1499
455,1498,198,79,279,942,1498
456,1498,197,77,287,937,1498
457,1498,191,89,281,937,1498
458,1498,198,79,283,938,1498
459,1495,185,84,289,937,1495
460,1492,174,94,290,934,1492
461,1498,172,90,301,935,1498
462,1500,165,90,301,944,1500
463,1499,159,90,299,951,1499
464,1496,157,83,306,950,1496
465,1497,154,82,309,952,1497
466,1498,140,86,320,952,1498
467,1500,147,80,321,952,1500
468,1497,140,73,324,960,1497
469,1497,146,58,324,969,1497
470,1497,142,59,327,969,1497
471,1497,136,74,319,968,1497
472,1499,136,77,311,975,1499
473,1493,135,79,302,977,1493
474,1497,133,75,308,981,1497
475,1491,135,56,311,989,1491
476,1492,133,58,304,997,1492
477,1497,132,61,297,1007,1497
478,1499,133,63,288,1015,1499
479,1498,134,67,275,1022,1498
480,1491,123,68,270,1030,1491
481,1486,124,64,270,1028,1486
482,1482,125,59,266,1032,1482
483,1478,119,58,256,1045,1478
484,1470,122,48,253,1047,1470
485,1479,126,50,255,1048,1479
486,1485,125,57,252,1051,1485
487,1494,129,65,252,1048,1494
488,1490,132,66,240,1052,1490
489,1485,137,63,227,1058,1485
490,1488,133,53,239,1063,1488
491,1494,138,52,233,1071,1494
492,1498,132,57,236,1073,1498
493,1499,132,54,239,1074,1499
494,1498,127,59,229,1083,1498
495,1499,132,56,224,1087,1499
496,1499,133,49,229,1088,1499
497,1499,132,52,223,1092,1499
498,1497,135,49,215,1098,1497
499,1500,142,48,215,1095,1500
500,1500,138,46,222,1094,1500
501,1498,136,51,218,1093,1498
502,1499,137,54,212,1096,1499
503,1499,136,47,216,1100,1499
504,1499,135,55,203,1106,1499
505,1500,132,56,202,1110,1500
506,1495,128,53,199,1115,1495
507,1500,134,50,195,1121,1500
508,1499,128,49,202,1120,1499
509,1499,121,51,208,1119,1499
510,1500,127,53,191,1129,1500
511,1499,126,50,192,1131,1499
512,1496,129,45,194,1128,1496
513,1500,140,34,200,1126,1500
514,1500,140,38,192,1130,1500
515,1500,139,42,190,1129,1500
516,1498,134,50,191,1123,1498
517,1497,135,49,185,1128,1497
518,1499,144,44,182,1129,1499
519,1499,153,40,183,1123,1499
520,1500,158,36,185,1121,1500
521,1500,161,36,183,1120,1500
522,1498,165,39,173,1121,1498
523,1500,160,54,164,1122,1500
524,1499,151,56,172,1120,1499
525,1498,154,60,167,1117,1498
526,1499,154,57,170,1118,1499
527,1499,160,55,169,1115,1499
528,1499,156,54,173,1116,1499
529,1500,159,52,176,1113,1500
530,1499,156,45,187,1111,1499
531,1500,162,40,188,1110,1500
532,1500,167,34,192,1107,1500
533,1499,168,41,185,1105,1499
534,1496,160,44,180,1112,1496
535,1499,164,50,180,1105,1499
536,1500,163,55,184,1098,1500
537,1498,154,59,187,1098,1498
538,1498,156,59,189,1094,1498
539,1500,163,54,198,1085,1500
540,1500,161,55,200,1084,1500
541,1500,157,62,192,1089,1500
542,1499,161,59,191,1088,1499
543,1496,166,52,196,1082,1496
544,1500,173,44,197,1086,1500
545,1496,175,46,197,1078,1496
546,1500,181,52,195,1072,1500
547,1500,175,61,201,1063,1500
548,1499,173,67,200,1059,1499
549,1499,179,62,208,1050,1499
550,1500,185,60,212,1043,1500
551,1498,179,61,223,1035,1498
552,1498,175,71,222,1030,1498
553,1499,179,74,215,1031,1499
554,1500,173,71,218,1038,1500
555,1500,170,73,228,1029,1500
556,1500,169,64,238,1029,1500
557,1495,160,69,237,1029,1495
558,1491,163,71,230,1027,1491
559,1495,165,61,243,1026,1495
560,1497,162,69,249,1017,1497
561,1500,167,71,252,1010,1500
562,1500,161,79,255,1005,1500
563,1500,163,69,260,1008,1500
564,1499,161,64,266,1008,1499
565,1496,163,68,261,1004,1496
566,1499,164,65,266,1004,1499
567,1500,158,68,272,1002,1500
568,1497,156,58,271,1012,1497
569,1499,144,67,267,1021,1499
570,1492,142,70,259,1021,1492
571,1500,135,82,259,1024,1500
572,1498,131,74,268,1025,1498
573,1492,127,75,259,1031,1492
574,1492,133,63,267,1029,1492
575,1495,138,57,269,1031,1495
576,1500,141,51,274,1034,1500
577,1494,144,51,269,1030,1494
578,1494,154,60,255,1025,1494
579,1491,151,56,258,1026,1491
580,1493,148,66,251,1028,1493
581,1493,144,73,246,1030,1493
582,1499,157,65,248,1029,1499
583,1499,159,71,249,1020,1499
584,1498,151,71,255,1021,1498
585,1499,157,70,255,1017,1499
586,1500,157,73,249,1021,1500
587,1499,155,68,254,1022,1499
588,1500,162,64,253,1021,1500
589,1496,165,74,248,1009,1496
590,1500,160,78,250,1012,1500
591,1497,150,85,249,1013,1497
592,1500,149,81,264,1006,1500
593,1499,142,84,262,1011,1499
594,1499,138,71,282,1008,1499
595,1499,140,71,285,1003,1499
596,1495,140,68,285,1002,1495
597,1499,141,75,289,994,1499
598,1496,139,80,284,993,1496
599,1498,132,95,283,988,1498
600,1499,140,83,293,983,1499
601,1497,143,75,291,988,1497
602,1497,147,69,290,991,1497
603,1500,156,59,302,983,1500
604,1499,155,59,297,988,1499
605,1498,152,60,296,990,1498
606,1496,153,59,290,994,1496
607,1498,156,61,288,993,1498
608,1485,156,68,269,992,1485
609,1490,159,74,271,986,1490
610,1487,157,78,266,986,1487
611,1493,166,76,266,985,1493
612,1495,168,73,267,987,1495
613,1493,156,72,278,987,1493
614,1488,159,70,272,987,1488
615,1489,159,76,264,990,1489
616,1495,163,78,261,993,1495
617,1497,165,70,264,998,1497
618,1500,158,84,262,996,1500
619,1499,153,73,276,997,1499
620,1500,154,79,270,997,1500
621,1494,145,73,278,998,1494
622,1497,144,64,291,998,1497
623,1497,141,68,292,996,1497
624,1500,150,68,291,991,1500
625,1496,136,81,287,992,1496
626,1498,136,81,287,994,1498
627,1495,140,76,280,999,1495
628,1500,143,67,286,1004,1500
629,1499,133,60,297,1009,1499
630,1497,135,67,291,1004,1497
631,1494,140,67,279,1008,1494
632,1498,142,57,285,1014,1498
633,1496,142,50,277,1027,1496
634,1498,145,51,281,1021,1498
635,1488,140,56,267,1025,1488
636,1482,139,50,257,1036,1482
637,1485,147,54,252,1032,1485
638,1485,146,55,252,1032,1485
639,1482,139,61,250,1032,1482
640,1486,144,67,242,1033,1486
641,1493,149,63,245,1036,1493
642,1498,149,63,242,1044,1498
643,1499,156,68,229,1046,1499
644,1500,145,73,231,1051,1500
645,1497,141,72,234,1050,1497
646,1498,145,64,237,1052,1498
647,1496,143,70,228,1055,1496
648,1499,143,64,239,1053,1499
649,1500,142,62,245,1051,1500
650,1496,131,63,246,1056,1496
651,1494,129,59,250,1056,1494
652,1497,132,53,252,1060,1497
653,1499,136,52,253,1058,1499
654,1499,131,59,258,1051,1499
655,1499,126,60,250,1063,1499
656,1499,128,63,240,1068,1499
657,1500,121,62,246,1071,1500
658,1500,123,57,250,1070,1500
659,1496,121,57,246,1072,1496
660,1497,125,59,239,1074,1497
661,1500,128,55,247,1070,1500
662,1498,135,53,236,1074,1498
663,1498,133,53,233,1079,1498
664,1499,139,50,231,1079,1499
665,1498,132,48,232,1086,1498
666,1499,145,45,223,1086,1499
667,1500,144,47,222,1087,1500
668,1500,145,47,218,1090,1500
669,1500,140,50,219,1091,1500
670,1499,136,54,213,1096,1499
671,1500,137,41,217,1105,1500
672,1497,146,38,208,1105,1497
673,1500,150,42,208,1100,1500
674,1495,149,51,200,1095,1495
675,1492,146,56,189,1101,1492
676,1497,154,57,185,1101,1497
677,1500,153,49,195,1103,1500
678,1500,163,47,188,1102,1500
679,1500,162,47,186,1105,1500
680,1500,149,53,190,1108,1500
681,1500,148,52,189,1111,1500
682,1500,150,54,186,1110,1500
683,1496,157,45,191,1103,1496
684,1500,149,49,202,1100,1500
685,1500,156,47,191,1106,1500
686,1499,165,45,188,1101,1499
687,1500,164,43,188,1105,1500
688,1500,155,52,197,1096,1500
689,1500,161,59,195,1085,1500
690,1499,163,62,194,1080,1499
691,1496,170,57,189,1080,1496
692,1499,169,52,200,1078,1499
693,1500,169,53,203,1075,1500
694,1500,164,62,197,1077,1500
695,1500,160,62,199,1079,1500
696,1500,156,59,207,1078,1500
697,1498,155,57,206,1080,1498
698,1499,161,50,207,1081,1499
699,1500,161,50,210,1079,1500
700,1500,159,54,213,1074,1500
701,1499,160,49,215,1075,1499
702,1498,166,53,211,1068,1498
703,1498,161,56,216,1065,1498
704,1500,161,58,219,1062,1500
705,1499,169,52,214,1064,1499
706,1499,174,48,213,1064,1499
707,1497,179,46,211,1061,1497
708,1500,179,57,211,1053,1500
709,1498,173,60,206,1059,1498
710,1498,180,60,205,1053,1498
711,1500,179,64,204,1053,1500
712,1500,173,63,204,1060,1500
713,1499,176,69,201,1053,1499
714,1499,173,66,211,1049,1499
715,1499,173,61,215,1050,1499
716,1499,179,63,217,1040,1499
717,1500,169,66,224,1041,1500
718,1500,170,68,226,1036,1500
719,1498,164,71,229,1034,1498
720,1496,159,75,230,1032,1496
721,1495,158,75,234,1028,1495
722,1500,166,75,241,1018,1500
723,1499,154,73,255,1017,1499
724,1500,160,62,264,1014,1500
725,1498,153,70,260,1015,1498
726,1500,154,67,264,1015,1500
727,1498,140,78,271,1009,1498
728,1497,145,83,262,1007,1497
729,1491,142,78,265,1006,1491
730,1498,161,61,274,1002,1498
731,1500,165,60,274,1001,1500
732,1497,163,55,283,996,1497
733,1498,161,62,279,996,1498
734,1499,153,79,271,996,1499
735,1500,154,78,270,998,1500
736,1497,155,79,271,992,1497
737,1493,151,78,272,992,1493
738,1494,146,82,268,998,1494
739,1500,141,87,275,997,1500
740,1493,142,81,273,997,1493
741,1495,144,75,277,999,1495
742,1498,137,67,299,995,1498
743,1498,140,68,289,1001,1498
744,1497,141,77,278,1001,1497
745,1499,138,71,285,1005,1499
746,1493,135,69,281,1008,1493
747,1500,143,65,288,1004,1500
748,1500,138,62,298,1002,1500
749,1499,138,67,293,1001,1499
750,1500,138,71,292,999,1500
751,1500,141,71,287,1001,1500
752,1498,139,79,281,999,1498
753,1496,142,79,285,990,1496
754,1496,138,81,283,994,1496
755,1497,134,77,285,1001,1497
756,1491,139,79,272,1001,1491
757,1496,144,74,279,999,1496
758,1500,140,71,289,1000,1500
759,1500,133,70,286,1011,1500
760,1500,126,72,285,1017,1500
761,1496,118,85,279,1014,1496
762,1493,112,88,280,1013,1493
763,1499,123,82,284,1010,1499
764,1499,118,73,298,1010,1499
765,1494,114,66,302,1012,1494
766,1499,129,58,304,1008,1499
767,1496,128,54,302,1012,1496
768,1494,128,54,298,1014,1494
769,1497,131,57,287,1022,1497
770,1500,138,59,277,1026,1500
771,1500,134,55,276,1035,1500
772,1497,142,54,268,1033,1497
773,1499,148,52,261,1038,1499
774,1499,145,59,253,1042,1499
775,1500,147,61,258,1034,1500
776,1496,147,68,250,1031,1496
777,1500,145,72,248,1035,1500
778,1493,145,78,233,1037,1493
779,1493,146,73,233,1041,1493
780,1494,155,65,238,1036,1494
781,1494,151,68,235,1040,1494
782,1496,165,61,239,1031,1496
783,1498,166,63,242,1027,1498
784,1500,160,68,247,1025,1500
785,1497,154,71,246,1026,1497
786,1499,142,84,250,1023,1499
787,1500,134,92,247,1027,1500
788,1500,140,76,262,1022,1500
789,1500,136,70,264,1030,1500
790,1500,133,58,279,1030,1500
791,1500,142,51,281,1026,1500
792,1500,143,56,278,1023,1500
793,1500,138,57,274,1031,1500
794,1500,129,69,262,1040,1500
795,1498,131,70,257,1040,1498
796,1500,136,60,261,1043,1500
797,1500,129,61,264,1046,1500
798,1498,123,62,265,1048,1498
799,1498,127,64,260,1047,1498
800,1500,133,55,261,1051,1500
801,1500,130,52,268,1050,1500
802,1497,133,48,260,1056,1497
803,1496,128,59,247,1062,1496
804,1491,136,56,230,1069,1491
805,1500,156,50,230,1064,1500
806,1500,151,47,233,1069,1500
807,1499,151,47,230,1071,1499
808,1500,147,54,228,1071,1500
809,1500,134,66,225,1075,1500
810,1497,133,60,220,1084,1497
811,1499,135,66,215,1083,1499
812,1499,132,63,218,1086,1499
813,1500,132,60,224,1084,1500
814,1497,134,62,217,1084,1497
815,1496,131,62,213,1090,1496
816,1500,134,62,213,1091,1500
817,1500,138,55,223,1084,1500
818,1500,136,56,225,1083,1500
819,1494,133,51,227,1083,1494
820,1499,129,57,226,1087,1499
821,1500,141,56,218,1085,1500
822,1500,128,58,229,1085,1500
823,1498,117,62,234,1085,1498
824,1495,120,59,231,1085,1495
825,1499,127,59,231,1082,1499
826,1497,131,53,232,1081,1497
827,1497,134,58,224,1081,1497
828,1500,136,52,229,1083,1500
829,1500,145,51,223,1081,1500
830,1497,148,42,226,1081,1497
831,1496,149,46,223,1078,1496
832,1497,159,48,217,1073,1497
833,1499,159,53,209,1078,1499
834,1499,160,48,210,1081,1499
835,1499,147,58,213,1081,1499
836,1500,136,61,209,1094,1500
837,1500,140,58,205,1097,1500
838,1500,130,67,204,1099,1500
839,1498,129,59,213,1097,1498
840,1500,134,55,207,1104,1500
841,1500,135,56,208,1101,1500
842,1500,132,50,212,1106,1500
843,1500,131,48,215,1106,1500
844,1496,140,46,208,1102,1496
845,1500,146,47,204,1103,1500
846,1499,143,49,213,1094,1499
847,1499,145,44,213,1097,1499
848,1500,148,54,206,1092,1500
849,1500,144,51,212,1093,1500
850,1500,141,51,212,1096,1500
851,1500,146,57,206,1091,1500
852,1500,138,58,210,1094,1500
853,1500,135,57,204,1104,1500
854,1500,141,58,200,1101,1500
855,1498,146,55,203,1094,1498
856,1497,145,50,202,1100,1497
857,1499,154,58,199,1088,1499
858,1499,157,62,200,1080,1499
859,1499,155,62,204,1078,1499
860,1500,156,59,205,1080,1500
861,1498,165,47,211,1075,1498
862,1500,151,50,219,1080,1500
863,1499,151,51,216,1081,1499
864,1500,160,54,210,1076,1500
865,1499,160,60,216,1063,1499
866,1500,164,59,218,1059,1500
867,1500,160,69,212,1059,1500
868,1499,159,67,216,1057,1499
869,1500,160,56,224,1060,1500
870,1499,152,57,220,1070,1499
871,1498,162,51,227,1058,1498
872,1499,161,59,222,1057,1499
873,1499,160,57,226,1056,1499
874,1500,163,59,222,1056,1500
875,1497,166,64,219,1048,1497
876,1500,177,66,217,1040,1500
877,1498,173,66,219,1040,1498
878,1500,168,60,232,1040,1500
879,1497,166,64,237,1030,1497
880,1500,169,76,229,1026,1500
881,1499,166,79,233,1021,1499
882,1499,165,77,240,1017,1499
883,1499,160,78,240,1021,1499
884,1499,154,74,248,1023,1499
885,1498,162,68,246,1022,1498
886,1500,161,66,255,1018,1500
887,1500,162,65,259,1014,1500
888,1499,148,73,262,1016,1499
889,1498,155,71,263,1009,1498
890,1500,154,80,263,1003,1500
891,1498,145,81,274,998,1498
892,1500,148,83,269,1000,1500
893,1500,150,73,274,1003,1500
894,1500,148,63,286,1003,1500
895,1498,143,52,299,1004,1498
896,1493,144,56,289,1004,1493
897,1492,147,62,277,1006,1492
898,1497,160,61,268,1008,1497
899,1498,160,62,272,1004,1498
900,1498,163,58,270,1007,1498
901,1498,168,55,265,1010,1498
902,1498,153,71,261,1013,1498
903,1500,157,64,262,1017,1500
904,1500,154,71,260,1015,1500
905,1496,150,68,260,1018,1496
906,1500,153,65,261,1021,1500
907,1494,149,71,252,1022,1494
908,1491,145,69,249,1028,1491
909,1496,155,70,239,1032,1496
910,1500,148,74,244,1034,1500
911,1500,149,67,253,1031,1500
912,1498,144,64,257,1033,1498
913,1494,149,62,258,1025,1494
914,1500,162,59,260,1019,1500
915,1498,161,64,255,1018,1498
916,1498,151,77,257,1013,1498
917,1498,146,77,260,1015,1498
918,1498,148,77,263,1010,1498
919,1497,150,72,256,1019,1497
920,1496,149,65,267,1015,1496
921,1500,151,67,269,1013,1500
922,1499,159,65,264,1011,1499
923,1499,158,61,270,1010,1499
924,1499,154,64,270,1011,1499
925,1500,161,67,262,1010,1500
926,1500,153,72,263,1012,1500
927,1499,158,64,266,1011,1499
928,1499,157,69,258,1015,1499
929,1500,143,72,268,1017,1500
930,1499,146,66,275,1012,1499
931,1500,159,59,270,1012,1500
932,1500,163,56,272,1009,1500
933,1498,161,47,275,1015,1498
934,1488,157,56,257,1018,1488
935,1493,166,62,252,1013,1493
936,1498,170,65,250,1013,1498
937,1498,159,72,244,1023,1498
938,1500,163,68,245,1024,1500
939,1499,163,66,248,1022,1499
940,1497,159,66,246,1026,1497
941,1498,156,63,244,1035,1498
942,1500,146,67,249,1038,1500
943,1500,148,62,242,1048,1500
944,1500,146,59,239,1056,1500
945,1497,149,52,238,1058,1497
946,1500,150,48,245,1057,1500
947,1499,147,61,230,1061,1499
948,1500,140,66,232,1062,1500
949,1498,134,71,233,1060,1498
950,1499,136,65,242,1056,1499
951,1495,128,60,249,1058,1495
952,1497,131,61,243,1062,1497
953,1497,137,57,245,1058,1497
954,1499,135,58,244,1062,1499
955,1500,140,54,238,1068,1500
956,1497,140,56,238,1063,1497
957,1497,147,50,239,1061,1497
958,1495,156,51,229,1059,1495
959,1495,152,52,230,1061,1495
960,1491,163,48,222,1058,1491
961,1499,160,55,224,1060,1499
962,1498,158,52,227,1061,1498
963,1500,152,56,229,1063,1500
964,1499,154,53,219,1073,1499
965,1498,149,55,215,1079,1498
966,1496,148,55,214,1079,1496
967,1497,147,57,213,1080,1497
968,1498,147,64,207,1080,1498
969,1498,141,68,208,1081,1498
970,1495,142,65,208,1080,1495
971,1492,134,63,213,1082,1492
972,1500,145,55,222,1078,1500
973,1499,154,55,220,1070,1499
974,1500,145,56,224,1075,1500
975,1500,141,54,230,1075,1500
976,1498,141,65,219,1073,1498
977,1498,133,60,228,1077,1498
978,1500,132,52,236,1080,1500
979,1499,136,52,227,1084,1499
980,1498,134,52,233,1079,1498
981,1497,130,54,232,1081,1497
982,1498,132,57,230,1079,1498
983,1500,135,63,223,1079,1500
984,1500,136,50,232,1082,1500
985,1500,135,49,223,1093,1500
986,1496,142,43,222,1089,1496
987,1499,152,41,219,1087,1499
988,1498,154,45,209,1090,1498
989,1498,156,48,207,1087,1498
990,1500,167,48,212,1073,1500
991,1500,168,48,202,1082,1500
992,1499,165,49,199,1086,1499
993,1500,168,49,201,1082,1500
994,1497,163,61,192,1081,1497
995,1498,178,49,193,1078,1498
996,1500,173,54,196,1077,1500
997,1500,167,53,204,1076,1500
998,1499,164,55,196,1084,1499
999,1500,156,69,187,1088,1500
1000,1499,151,66,193,1089,1499
1001,1500,147,61,200,1092,1500
1002,1500,152,54,206,1088,1500
1003,1496,154,52,211,1079,1496
1004,1499,156,55,215,1073,1499
1005,1500,151,58,217,1074,1500
1006,1498,148,60,210,1080,1498
1007,1500,162,47,215,1076,1500
1008,1500,156,51,222,1071,1500
1009,1498,155,45,224,1074,1498
1010,1499,148,57,220,1074,1499
1011,1500,158,58,211,1073,1500
1012,1500,156,61,211,1072,1500
1013,1500,154,63,223,1060,1500
1014,1500,156,56,220,1068,1500
1015,1497,158,58,210,1071,1497
1016,1500,156,55,218,1071,1500
1017,1497,159,63,210,1065,1497
1018,1499,162,62,212,1063,1499
1019,1498,156,69,209,1064,1498
1020,1500,157,63,221,1059,1500
1021,1500,163,61,220,1056,1500
1022,1499,159,61,222,1057,1499
1023,1500,161,65,217,1057,1500
1024,1499,161,59,226,1053,1499
1025,1498,158,67,233,1040,1498
1026,1498,167,57,238,1036,1498
1027,1500,173,64,233,1030,1500
1028,1495,171,67,230,1027,1495
1029,1499,177,66,243,1013,1499
1030,1500,174,77,234,1015,1500
1031,1499,169,80,237,1013,1499
1032,1497,163,79,242,1013,1497
1033,1500,158,72,257,1013,1500
1034,1498,157,71,253,1017,1498
1035,1499,159,63,257,1020,1499
1036,1500,152,66,259,1023,1500
1037,1495,147,72,263,1013,1495
1038,1494,139,76,262,1017,1494
1039,1500,158,70,261,1011,1500
1040,1497,159,59,264,1015,1497
1041,1499,154,54,274,1017,1499
1042,1497,155,53,273,1016,1497
1043,1497,154,57,268,1018,1497
1044,1500,155,66,265,1014,1500
1045,1499,159,61,269,1010,1499
1046,1496,162,62,260,1012,1496
1047,1488,154,66,258,1010,1488
1048,1488,153,69,259,1007,1488
1049,1494,158,77,247,1012,1494
1050,1495,159,75,248,1013,1495
1051,1498,161,63,257,1017,1498
1052,1500,156,70,257,1017,1500
1053,1497,160,67,261,1009,1497
1054,1500,162,72,254,1012,1500
1055,1500,163,68,253,1016,1500
1056,1500,159,68,254,1019,1500
1057,1498,165,59,260,1014,1498
1058,1498,155,66,266,1011,1498
1059,1496,151,66,266,1013,1496
1060,1497,155,67,266,1009,1497
1061,1494,156,68,265,1005,1494
1062,1500,152,73,264,1011,1500
1063,1499,151,78,269,1001,1499
1064,1498,159,76,266,997,1498
1065,1496,157,79,259,1001,1496
1066,1498,155,72,268,1003,1498
1067,1499,150,79,268,1002,1499
1068,1496,146,79,268,1003,1496
1069,1498,147,71,273,1007,1498
1070,1500,143,69,273,1015,1500
1071,1498,143,56,277,1022,1498
1072,1495,138,63,276,1018,1495
1073,1495,137,67,271,1020,1495
1074,1498,148,59,277,1014,1498
1075,1499,151,65,268,1015,1499
1076,1500,140,68,273,1019,1500
1077,1499,126,80,271,1022,1499
1078,1500,123,81,272,1024,1500
1079,1492,122,74,271,1025,1492
1080,1493,135,61,270,1027,1493
1081,1498,147,48,275,1028,1498
1082,1496,135,61,274,1026,1496
1083,1495,129,76,259,1031,1495
1084,1497,132,86,255,1024,1497
1085,1494,138,88,248,1020,1494
1086,1496,136,78,258,1024,1496
1087,1499,129,75,269,1026,1499
1088,1500,129,70,272,1029,1500
1089,1499,128,65,280,1026,1499
1090,1499,132,62,274,1031,1499
1091,1500,121,67,281,1031,1500
1092,1497,119,63,282,1033,1497
1093,1499,115,69,276,1039,1499
1094,1495,129,58,273,1035,1495
1095,1488,129,50,270,1039,1488
1096,1489,127,58,269,1035,1489
1097,1493,128,62,270,1033,1493
1098,1499,134,65,270,1030,1499
1099,1499,128,68,271,1032,1499
1100,1495,122,73,261,1039,1495
1101,1499,135,64,253,1047,1499
1102,1498,130,61,248,1059,1498
1103,1491,133,51,253,1054,1491
1104,1500,147,47,251,1055,1500
1105,1491,145,56,240,1050,1491
1106,1493,152,50,239,1052,1493
1107,1494,152,56,237,1049,1494
1108,1493,152,59,230,1052,1493
1109,1496,154,64,223,1055,1496
1110,1498,150,58,227,1063,1498
1111,1500,149,68,226,1057,1500
1112,1498,149,64,233,1052,1498
1113,1496,149,59,231,1057,1496
1114,1500,153,64,230,1053,1500
1115,1500,153,59,234,1054,1500
1116,1497,146,64,231,1056,1497
1117,1494,138,68,222,1066,1494
1118,1500,153,62,224,1061,1500
1119,1500,150,60,234,1056,1500
1120,1498,159,53,235,1051,1498
1121,1500,152,59,238,1051,1500
1122,1500,147,60,240,1053,1500
1123,1500,149,53,242,1056,1500
1124,1499,148,53,237,1061,1499
1125,1500,141,53,245,1061,1500
1126,1499,137,57,239,1066,1499
1127,1500,137,62,229,1072,1500
1128,1499,133,61,229,1076,1499
1129,1499,143,49,230,1077,1499
1130,1499,150,44,231,1074,1499
1131,1500,154,43,227,1076,1500
1132,1499,160,43,221,1075,1499
1133,1500,153,49,212,1086,1500
1134,1497,163,49,205,1080,1497
1135,1500,164,56,204,1076,1500
1136,1500,159,65,201,1075,1500
1137,1491,157,63,201,1070,1491
1138,1495,162,65,198,1070,1495
1139,1497,173,51,203,1070,1497
1140,1493,169,43,212,1069,1493
1141,1500,167,57,213,1063,1500
1142,1500,164,57,213,1066,1500
1143,1499,164,67,199,1069,1499
1144,1500,163,63,201,1073,1500
1145,1499,154,61,207,1077,1499
1146,1500,152,57,215,1076,1500
1147,1500,141,62,220,1077,1500
1148,1498,143,57,222,1076,1498
1149,1499,144,57,224,1074,1499
1150,1499,154,46,231,1068,1499
1151,1496,145,52,228,1071,1496
1152,1500,149,53,230,1068,1500
1153,1498,148,62,218,1070,1498
1154,1497,158,63,208,1068,1497
1155,1498,158,60,221,1059,1498
1156,1500,157,61,220,1062,1500
1157,1499,145,62,230,1062,1499
1158,1498,150,64,227,1057,1498
1159,1500,155,64,224,1057,1500
1160,1499,159,61,221,1058,1499
1161,1500,158,57,224,1061,1500
1162,1499,154,60,226,1059,1499
1163,1493,150,62,227,1054,1493
1164,1495,156,60,222,1057,1495
1165,1500,149,64,223,1064,1500
1166,1498,157,56,229,1056,1498
1167,1499,162,48,236,1053,1499
1168,1500,163,49,235,1053,1500
1169,1500,175,45,230,1050,1500
1170,1499,183,40,227,1049,1499
1171,1498,189,45,219,1045,1498
1172,1500,188,43,223,1046,1500
1173,1497,174,61,214,1048,1497
1174,1500,179,70,210,1041,1500
1175,1498,180,78,204,1036,1498
1176,1493,191,65,208,1029,1493
1177,1491,181,69,218,1023,1491
1178,1497,186,66,218,1027,1497
1179,1500,179,72,221,1028,1500
1180,1495,174,68,223,1030,1495
1181,1499,176,71,223,1029,1499
1182,1499,172,74,229,1024,1499
1183,1499,163,74,232,1030,1499
1184,1500,158,80,236,1026,1500
1185,1499,158,69,254,1018,1499
1186,1500,159,73,250,1018,1500
1187,1500,156,68,264,1012,1500
1188,1496,158,55,274,1009,1496
1189,1493,158,56,277,1002,1493
1190,1496,166,50,277,1003,1496
1191,1497,178,57,264,998,1497
1192,1500,173,72,257,998,1500
1193,1494,166,71,262,995,1494
1194,1497,163,75,256,1003,1497
1195,1496,167,74,259,996,1496
1196,1499,167,75,262,995,1499
1197,1499,173,74,259,993,1499
1198,1500,172,70,266,992,1500
1199,1500,171,69,258,1002,1500
1200,1495,165,67,266,997,1495
1201,1499,168,64,264,1003,1499
1202,1498,166,72,254,1006,1498
1203,1500,166,72,258,1004,1500
1204,1495,158,65,264,1008,1495
1205,1496,163,71,262,1000,1496
1206,1500,155,76,273,996,1500
1207,1499,150,75,273,1001,1499
1208,1497,143,76,277,1001,1497
1209,1495,140,78,272,1005,1495
1210,1499,148,72,275,1004,1499
1211,1500,151,63,280,1006,1500
1212,1497,148,60,277,1012,1497
1213,1495,147,66,274,1008,1495
1214,1500,148,71,268,1013,1500
1215,1498,150,67,267,1014,1498
1216,1498,145,66,272,1015,1498
1217,1499,142,65,271,1021,1499
1218,1489,140,59,266,1024,1489
1219,1492,136,67,272,1017,1492
1220,1494,146,67,268,1013,1494
1221,1496,152,75,257,1012,1496
1222,1496,160,71,260,1005,1496
1223,1500,157,63,271,1009,1500
1224,1499,160,66,259,1014,1499
1225,1494,160,59,258,1017,1494
1226,1497,160,63,255,1019,1497
1227,1499,141,72,257,1029,1499
1228,1499,140,77,254,1028,1499
1229,1500,139,81,249,1031,1500
1230,1498,141,68,258,1031,1498
1231,1500,141,58,266,1035,1500
1232,1499,141,61,260,1037,1499
1233,1500,140,65,260,1035,1500
1234,1496,134,69,258,1035,1496
1235,1500,128,66,269,1037,1500
1236,1496,131,62,263,1040,1496
1237,1500,144,57,256,1043,1500
1238,1494,140,54,264,1036,1494
1239,1498,143,57,256,1042,1498
1240,1494,142,62,250,1040,1494
1241,1491,136,56,256,1043,1491
1242,1494,140,60,254,1040,1494
1243,1498,141,62,257,1038,1498
1244,1496,135,71,248,1042,1496
1245,1500,136,73,242,1049,1500
1246,1495,141,77,237,1040,1495
1247,1500,145,79,242,1034,1500
1248,1499,140,73,254,1032,1499
1249,1493,134,73,253,1033,1493
1250,1500,139,67,256,1038,1500
1251,1499,144,64,255,1036,1499
1252,1497,151,59,253,1034,1497
1253,1500,145,66,260,1029,1500
1254,1500,139,73,262,1026,1500
1255,1492,132,77,255,1028,1492
1256,1500,137,75,263,1025,1500
1257,1499,132,65,269,1033,1499
1258,1495,130,59,273,1033,1495
1259,1498,124,64,275,1035,1498
1260,1500,122,65,276,1037,1500
1261,1500,127,63,267,1043,1500
1262,1494,130,53,265,1046,1494
1263,1496,135,50,265,1046,1496
1264,1498,144,49,254,1051,1498
1265,1493,139,54,248,1052,1493
1266,1495,132,61,245,1057,1495
1267,1496,136,56,243,1061,1496
1268,1499,136,59,241,1063,1499
1269,1498,135,58,237,1068,1498
1270,1499,138,48,240,1073,1499
1271,1495,138,51,231,1075,1495
1272,1497,139,50,224,1084,1497
1273,1494,139,56,212,1087,1494
1274,1499,144,56,217,1082,1499
1275,1500,140,55,219,1086,1500
1276,1496,149,54,210,1083,1496
1277,1499,153,47,209,1090,1499
1278,1499,142,55,212,1090,1499
1279,1499,152,54,211,1082,1499
1280,1500,150,58,210,1082,1500
1281,1499,154,58,205,1082,1499
1282,1498,152,51,214,1081,1498
1283,1499,148,58,213,1080,1499
1284,1500,150,65,205,1080,1500
1285,1499,157,64,207,1071,1499
1286,1500,151,64,209,1076,1500
1287,1499,142,65,217,1075,1499
1288,1500,131,69,221,1079,1500
1289,1500,122,79,218,1081,1500
1290,1500,132,65,223,1080,1500
1291,1498,134,63,224,1077,1498
1292,1500,132,56,237,1075,1500
1293,1500,130,56,241,1073,1500
1294,1498,134,59,236,1069,1498
1295,1499,138,53,239,1069,1499
1296,1492,127,51,240,1074,1492
1297,1498,135,47,238,1078,1498
1298,1499,140,47,239,1073,1499
1299,1497,143,48,236,1070,1497
1300,1500,145,49,236,1070,1500
1301,1500,140,62,227,1071,1500
1302,1498,147,55,220,1076,1498
1303,1499,152,57,220,1070,1499
1304,1497,157,41,226,1073,1497
1305,1497,153,48,217,1079,1497
1306,1500,168,50,204,1078,1500
1307,1500,160,61,197,1082,1500
1308,1500,153,63,201,1083,1500
1309,1500,149,61,201,1089,1500
1310,1500,154,58,199,1089,1500
1311,1500,155,51,210,1084,1500
1312,1499,154,57,203,1085,1499
1313,1499,147,56,209,1087,1499
1314,1500,153,61,205,1081,1500
1315,1500,151,57,213,1079,1500
1316,1498,155,58,214,1071,1498
1317,1500,159,55,217,1069,1500
1318,1498,161,52,210,1075,1498
1319,1497,166,57,212,1062,1497
1320,1500,166,56,217,1061,1500
1321,1500,170,57,222,1051,1500
1322,1497,172,62,219,1044,1497
1323,1495,177,55,223,1040,1495
1324,1499,186,59,219,1035,1499
1325,1500,185,63,213,1039,1500
1326,1500,173,67,221,1039,1500
1327,1500,173,67,221,1039,1500
1328,1498,161,75,225,1037,1498
1329,1498,161,74,227,1036,1498
1330,1495,157,74,234,1030,1495
1331,1497,158,77,235,1027,1497
1332,1493,164,67,242,1020,1493
1333,1499,168,69,246,1016,1499
1334,1500,172,60,252,1016,1500
1335,1498,173,64,252,1009,1498
1336,1500,168,66,261,1005,1500
1337,1496,160,77,257,1002,1496
1338,1497,154,82,259,1002,1497
1339,1498,147,82,263,1006,1498
1340,1499,147,76,272,1004,1499
1341,1495,146,76,272,1001,1495
1342,1492,151,65,281,995,1492
1343,1493,151,68,282,992,1493
1344,1493,153,72,277,991,1493
1345,1497,143,79,283,992,1497
1346,1498,144,83,273,998,1498
1347,1500,146,86,273,995,1500
1348,1499,150,76,275,998,1499
1349,1497,152,67,288,990,1497
1350,1499,155,60,292,992,1499
1351,1498,154,65,290,989,1498
1352,1500,152,68,293,987,1500
1353,1500,149,75,287,989,1500
1354,1497,138,80,283,996,1497
1355,1500,142,78,281,999,1500
1356,1500,146,74,278,1002,1500
1357,1496,153,68,283,992,1496
1358,1499,141,72,287,999,1499
1359,1496,130,85,280,1001,1496
1360,1500,134,82,281,1003,1500
1361,1495,133,71,289,1002,1495
1362,1496,128,64,291,1013,1496
1363,1491,126,59,284,1022,1491
1364,1493,134,68,273,1018,1493
1365,1500,142,70,276,1012,1500
1366,1498,139,62,279,1018,1498
1367,1498,134,70,277,1017,1498
1368,1492,131,63,280,1018,1492
1369,1497,133,64,284,1016,1497
1370,1496,138,68,273,1017,1496
1371,1497,141,59,273,1024,1497
1372,1499,139,64,268,1028,1499
1373,1500,135,66,271,1028,1500
1374,1500,135,67,269,1029,1500
1375,1500,134,69,261,1036,1500
1376,1497,132,67,256,1042,1497
1377,1500,130,72,254,1044,1500
1378,1500,132,67,260,1041,1500
1379,1499,134,62,263,1040,1499
1380,1500,130,59,261,1050,1500
1381,1499,137,50,269,1043,1499
1382,1499,147,52,258,1042,1499
1383,1499,135,67,254,1043,1499
1384,1500,139,68,256,1037,1500
1385,1495,139,70,243,1043,1495
1386,1495,143,60,254,1038,1495
1387,1496,148,52,258,1038,1496
1388,1500,150,55,257,1038,1500
1389,1498,149,53,254,1042,1498
1390,1500,158,48,252,1042,1500
1391,1500,153,59,244,1044,1500
1392,1496,157,60,240,1039,1496
1393,1496,160,64,234,1038,1496
1394,1497,160,64,229,1044,1497
1395,1499,161,62,229,1047,1499
1396,1498,160,61,232,1045,1498
1397,1500,159,64,234,1043,1500
1398,1500,157,61,237,1045,1500
1399,1500,155,57,241,1047,1500
1400,1498,161,56,231,1050,1498
1401,1498,162,61,226,1049,1498
1402,1499,160,60,229,1050,1499
1403,1500,155,64,228,1053,1500
1404,1499,159,68,221,1051,1499
1405,1500,149,62,231,1058,1500
1406,1499,151,58,233,1057,1499
1407,1500,148,52,239,1061,1500
1408,1495,144,56,239,1056,1495
1409,1492,146,60,233,1053,1492
1410,1496,153,65,229,1049,1496
1411,1496,151,66,225,1054,1496
1412,1500,153,62,228,1057,1500
1413,1496,153,56,231,1056,1496
1414,1498,151,57,231,1059,1498
1415,1498,156,53,231,1058,1498
1416,1500,156,53,231,1060,1500
1417,1499,161,51,230,1057,1499
1418,1495,145,63,231,1056,1495
1419,1499,136,69,229,1065,1499
1420,1499,140,73,224,1062,1499
1421,1500,145,76,217,1062,1500
1422,1497,150,59,231,1057,1497
1423,1499,149,59,234,1057,1499
1424,1499,147,56,241,1055,1499
1425,1500,155,53,241,1051,1500
1426,1497,155,53,235,1054,1497
1427,1497,159,47,233,1058,1497
1428,1499,165,42,233,1059,1499
1429,1497,158,53,225,1061,1497
1430,1498,163,54,223,1058,1498
1431,1499,155,66,220,1058,1499
1432,1498,152,67,220,1059,1498
1433,1498,154,63,224,1057,1498
1434,1497,154,62,227,1054,1497
1435,1499,154,57,237,1051,1499
1436,1496,144,70,218,1064,1496
1437,1494,144,65,220,1065,1494
1438,1494,142,73,218,1061,1494
1439,1500,139,68,223,1070,1500
