ticks,turtles,healthy turtles,exposed turtles,infected turtles,immune turtles,masked turtles
0,1500,1490,10,0,0,1500
1,1500,1490,10,0,0,1500
2,1500,1490,10,0,0,1500
3,1500,1488,2,10,0,1500
4,1500,1488,2,10,0,1500
5,1500,1483,7,10,0,1500
6,1500,1482,8,10,0,1500
7,1500,1479,9,12,0,1500
8,1500,1477,10,13,0,1500
9,1500,1475,7,18,0,1500
10,1500,1468,11,21,0,1500
11,1500,1463,16,21,0,1500
12,1500,1459,17,24,0,1500
13,1500,1450,20,30,0,1500
14,1500,1437,29,34,0,1500
15,1500,1422,39,39,0,1500
16,1500,1409,47,44,0,1500
17,1499,1397,50,47,5,1499
18,1500,1377,58,60,5,1500
19,1500,1354,68,73,5,1500
20,1500,1326,83,86,5,1500
21,1500,1294,91,108,7,1500
22,1500,1261,104,128,7,1500
23,1500,1234,110,147,9,1500
24,1500,1189,124,177,10,1500
25,1500,1156,128,206,10,1500
26,1500,1105,152,232,11,1500
27,1499,1054,164,267,14,1499
28,1500,995,189,300,16,1500
29,1500,942,201,341,16,1500
30,1500,879,215,387,19,1500
31,1500,807,242,427,24,1500
32,1500,733,256,482,29,1500
33,1500,681,257,524,38,1500
34,1499,626,245,582,46,1499
35,1490,561,222,652,55,1490
36,1493,510,223,690,70,1493
37,1491,456,219,728,88,1491
38,1487,417,201,762,107,1487
39,1478,363,196,800,119,1478
40,1472,323,187,829,133,1472
41,1454,287,180,835,152,1454
42,1438,254,163,849,172,1438
43,1409,223,133,867,186,1409
44,1388,200,121,857,210,1388
45,1361,184,105,841,231,1361
46,1332,172,90,811,259,1332
47,1314,156,80,790,288,1314
48,1280,143,77,740,320,1280
49,1247,131,74,669,373,1247
50,1227,115,78,628,406,1227
51,1201,107,66,590,438,1201
52,1173,100,62,543,468,1173
53,1147,104,44,499,500,1147
54,1127,97,38,458,534,1127
55,1107,85,41,424,557,1107
56,1087,84,37,384,582,1087
57,1063,87,32,328,616,1063
58,1051,94,23,301,633,1051
59,1047,105,19,274,649,1047
60,1035,107,16,244,668,1035
61,1019,101,20,214,684,1019
62,1023,114,16,197,696,1023
63,1023,122,14,180,707,1023
64,1023,126,13,167,717,1023
65,1016,128,9,148,731,1016
66,1013,132,12,130,739,1013
67,1017,145,10,111,751,1017
68,1016,151,10,97,758,1016
69,1016,155,13,85,763,1016
70,1021,160,11,80,770,1021
71,1024,164,11,75,774,1024
72,1020,164,14,62,780,1020
73,1022,169,12,57,784,1022
74,1026,171,11,54,790,1026
75,1031,177,10,51,793,1031
76,1035,182,8,51,794,1035
77,1043,191,7,48,797,1043
78,1047,194,6,46,801,1047
79,1045,196,5,42,802,1045
80,1052,203,5,42,802,1052
81,1056,207,7,40,802,1056
82,1066,217,7,38,804,1066
83,1073,222,7,39,805,1073
84,1081,228,9,34,810,1081
85,1086,234,8,34,810,1086
86,1098,244,7,36,811,1098
87,1109,255,6,34,814,1109
88,1113,254,8,32,819,1113
89,1123,263,7,32,821,1123
90,1129,272,7,28,822,1129
91,1136,279,6,27,824,1136
92,1147,289,5,28,825,1147
93,1158,297,7,28,826,1158
94,1169,307,8,27,827,1169
95,1181,316,10,27,828,1181
96,1193,326,9,29,829,1193
97,1205,339,8,29,829,1205
98,1217,347,8,32,830,1217
99,1228,356,11,30,831,1228
100,1238,364,13,30,831,1238
101,1250,375,11,31,833,1250
102,1253,379,10,31,833,1253
103,1265,388,8,34,835,1265
104,1274,395,8,36,835,1274
105,1286,402,13,35,836,1286
106,1296,412,12,35,837,1296
107,1309,425,10,37,837,1309
108,1321,433,12,38,838,1321
109,1330,441,7,43,839,1330
110,1342,452,9,40,841,1342
111,1352,457,11,41,843,1352
112,1360,464,13,39,844,1360
113,1368,469,14,41,844,1368
114,1372,473,14,41,844,1372
115,1390,485,16,43,846,1390
116,1401,494,15,44,848,1401
117,1411,502,17,42,850,1411
118,1424,514,15,44,851,1424
119,1436,523,13,48,852,1436
120,1449,532,11,50,856,1449
121,1464,546,11,50,857,1464
122,1476,557,13,49,857,1476
123,1486,567,13,47,859,1486
124,1500,573,18,50,859,1500
125,1500,569,20,50,861,1500
126,1500,567,16,54,863,1500
127,1500,562,13,60,865,1500
128,1500,562,14,58,866,1500
129,1500,561,12,58,869,1500
130,1500,556,19,55,870,1500
131,1500,555,17,58,870,1500
132,1500,552,17,59,872,1500
133,1500,546,20,58,876,1500
134,1500,544,20,59,877,1500
135,1500,540,24,58,878,1500
136,1500,537,21,64,878,1500
137,1500,537,19,67,877,1500
138,1500,533,22,67,878,1500
139,1500,529,19,73,879,1500
140,1500,521,27,71,881,1500
141,1500,523,26,69,882,1500
142,1500,518,26,74,882,1500
143,1500,515,25,76,884,1500
144,1500,509,21,87,883,1500
145,1500,508,25,84,883,1500
146,1499,503,22,88,886,1499
147,1500,505,22,89,884,1500
148,1500,503,24,86,887,1500
149,1500,494,22,95,889,1500
150,1500,492,26,93,889,1500
151,1500,488,31,92,889,1500
152,1500,489,31,94,886,1500
153,1500,482,38,96,884,1500
154,1500,483,36,102,879,1500
155,1500,488,35,102,875,1500
156,1500,498,33,106,863,1500
157,1500,516,24,114,846,1500
158,1500,530,28,110,832,1500
159,1500,532,35,111,822,1500
160,1499,538,38,111,812,1499
161,1500,551,38,115,796,1500
162,1500,560,38,123,779,1500
163,1496,570,34,124,768,1496
164,1500,583,41,130,746,1500
165,1500,593,49,132,726,1500
166,1500,609,53,137,701,1500
167,1500,629,55,139,677,1500
168,1500,642,62,144,652,1500
169,1500,683,60,154,603,1500
170,1500,706,62,158,574,1500
171,1495,718,69,162,546,1495
172,1500,721,82,174,523,1500
173,1499,727,97,183,492,1499
174,1500,741,100,198,461,1500
175,1497,742,96,217,442,1497
176,1499,739,104,231,425,1499
177,1499,748,108,248,395,1499
178,1499,734,115,265,385,1499
179,1500,719,124,283,374,1500
180,1500,703,132,305,360,1500
181,1499,688,134,328,349,1499
182,1499,667,137,349,346,1499
183,1500,647,143,366,344,1500
184,1499,631,137,392,339,1499
185,1498,621,128,416,333,1498
186,1498,610,126,431,331,1498
187,1498,586,134,454,324,1498
188,1500,561,135,471,333,1500
189,1490,532,145,474,339,1490
190,1486,509,147,486,344,1486
191,1483,486,136,504,357,1483
192,1474,463,136,510,365,1474
193,1470,439,124,533,374,1470
194,1467,424,121,535,387,1467
195,1459,408,119,531,401,1459
196,1450,368,130,531,421,1450
197,1445,344,127,534,440,1445
198,1433,325,128,524,456,1433
199,1422,307,119,516,480,1422
200,1411,286,108,523,494,1411
201,1407,269,104,519,515,1407
202,1398,250,99,512,537,1398
203,1390,233,99,505,553,1390
204,1382,228,89,496,569,1382
205,1367,217,77,484,589,1367
206,1364,211,69,478,606,1364
207,1348,199,81,442,626,1348
208,1336,202,69,432,633,1336
209,1333,202,59,422,650,1333
210,1321,200,50,408,663,1321
211,1308,192,47,387,682,1308
212,1298,182,52,371,693,1298
213,1289,179,49,351,710,1289
214,1282,178,47,322,735,1282
215,1277,180,45,304,748,1277
216,1263,174,41,286,762,1263
217,1262,170,38,276,778,1262
218,1259,175,39,256,789,1259
219,1252,174,34,235,809,1252
220,1239,168,39,214,818,1239
221,1243,170,35,212,826,1243
222,1239,170,30,199,840,1239
223,1234,178,26,186,844,1234
224,1232,184,21,173,854,1232
225,1232,187,17,164,864,1232
226,1235,193,15,157,870,1235
227,1234,193,20,147,874,1234
228,1236,199,22,137,878,1236
229,1239,208,21,129,881,1239
230,1240,221,18,117,884,1240
231,1244,228,16,111,889,1244
232,1253,239,13,108,893,1253
233,1254,239,18,97,900,1254
234,1260,244,21,93,902,1260
235,1268,254,22,87,905,1268
236,1274,261,22,82,909,1274
237,1278,269,18,80,911,1278
238,1281,274,15,80,912,1281
239,1286,277,20,75,914,1286
240,1291,289,17,73,912,1291
241,1300,293,19,74,914,1300
242,1315,304,21,76,914,1315
243,1324,316,18,76,914,1324
244,1340,327,23,75,915,1340
245,1356,339,20,77,920,1356
246,1371,353,22,74,922,1371
247,1383,361,23,77,922,1383
248,1397,371,23,80,923,1397
249,1409,386,17,83,923,1409
250,1423,400,16,82,925,1423
251,1437,414,17,80,926,1437
252,1445,421,21,77,926,1445
253,1459,438,21,77,923,1459
254,1473,446,24,78,925,1473
255,1480,452,22,79,927,1480
256,1495,460,25,81,929,1495
257,1500,466,26,81,927,1500
258,1500,461,28,84,927,1500
259,1500,457,29,83,931,1500
260,1500,450,31,87,932,1500
261,1500,449,29,89,933,1500
262,1499,444,27,92,936,1499
263,1500,447,26,92,935,1500
264,1500,443,27,94,936,1500
265,1500,438,30,95,937,1500
266,1500,437,30,96,937,1500
267,1500,428,33,102,937,1500
268,1500,428,32,105,935,1500
269,1500,426,29,108,937,1500
270,1500,424,26,110,940,1500
271,1499,422,23,115,939,1499
272,1500,420,29,113,938,1500
273,1499,419,33,111,936,1499
274,1500,416,36,112,936,1500
275,1500,417,35,113,935,1500
276,1500,414,38,111,937,1500
277,1499,407,33,117,942,1499
278,1500,411,28,120,941,1500
279,1500,401,36,121,942,1500
280,1500,402,31,125,942,1500
281,1500,398,35,124,943,1500
282,1500,394,33,127,946,1500
283,1499,394,34,124,947,1499
284,1497,393,29,127,948,1497
285,1500,389,29,126,956,1500
286,1500,387,31,128,954,1500
287,1500,383,34,130,953,1500
288,1500,391,31,130,948,1500
289,1500,394,25,131,950,1500
290,1500,392,22,136,950,1500
291,1499,395,22,127,955,1499
292,1500,404,23,120,953,1500
293,1499,394,28,120,957,1499
294,1499,392,27,119,961,1499
295,1500,386,37,115,962,1500
296,1500,391,38,111,960,1500
297,1499,389,36,113,961,1499
298,1500,390,33,118,959,1500
299,1499,388,37,114,960,1499
300,1500,392,35,117,956,1500
301,1497,390,38,114,955,1497
302,1500,395,33,122,950,1500
303,1499,390,40,121,948,1499
304,1500,395,40,118,947,1500
305,1500,397,41,119,943,1500
306,1500,394,37,131,938,1500
307,1500,388,37,139,936,1500
308,1500,400,41,134,925,1500
309,1500,402,42,140,916,1500
310,1500,401,39,148,912,1500
311,1500,407,42,152,899,1500
312,1499,425,38,144,892,1499
313,1500,429,40,148,883,1500
314,1498,440,37,154,867,1498
315,1498,447,40,158,853,1498
316,1498,465,45,150,838,1498
317,1500,479,47,155,819,1500
318,1500,488,54,157,801,1500
319,1500,500,57,164,779,1500
320,1497,502,60,164,771,1497
321,1500,506,73,162,759,1500
322,1499,507,78,176,738,1499
323,1500,517,70,187,726,1500
324,1500,526,76,186,712,1500
325,1498,530,67,201,700,1498
326,1500,540,63,212,685,1500
327,1498,544,71,218,665,1498
328,1498,528,88,222,660,1498
329,1500,535,89,230,646,1500
330,1500,526,96,242,636,1500
331,1498,522,95,259,622,1498
332,1498,512,97,276,613,1498
333,1498,511,99,285,603,1498
334,1500,508,108,297,587,1500
335,1497,490,111,319,577,1497
336,1498,491,111,324,572,1498
337,1496,481,119,332,564,1496
338,1495,463,121,353,558,1495
339,1488,454,122,361,551,1488
340,1489,440,126,370,553,1489
341,1492,420,125,393,554,1492
342,1492,423,111,408,550,1492
343,1496,404,110,428,554,1496
344,1496,382,119,441,554,1496
345,1495,375,126,437,557,1495
346,1486,348,138,439,561,1486
347,1489,339,129,455,566,1489
348,1490,316,122,473,579,1490
349,1482,291,124,473,594,1482
350,1483,282,120,482,599,1483
351,1477,279,100,494,604,1477
352,1467,258,100,493,616,1467
353,1450,249,93,486,622,1450
354,1445,239,94,479,633,1445
355,1428,219,98,466,645,1428
356,1432,212,98,460,662,1432
357,1420,206,92,448,674,1420
358,1412,201,79,442,690,1412
359,1409,190,73,445,701,1409
360,1404,179,70,439,716,1404
361,1395,180,65,417,733,1395
362,1378,168,65,390,755,1378
363,1371,164,50,382,775,1371
364,1360,161,44,366,789,1360
365,1348,162,46,337,803,1348
366,1338,167,39,318,814,1338
367,1333,168,38,302,825,1333
368,1330,168,37,291,834,1330
369,1333,168,39,277,849,1333
370,1328,172,43,257,856,1328
371,1324,170,43,242,869,1324
372,1319,167,47,224,881,1319
373,1311,172,42,205,892,1311
374,1320,183,37,196,904,1320
375,1325,189,33,192,911,1325
376,1328,192,31,186,919,1328
377,1325,199,31,166,929,1325
378,1333,211,28,158,936,1333
379,1338,221,29,156,932,1338
380,1342,223,34,149,936,1342
381,1344,229,34,144,937,1344
382,1354,241,30,141,942,1354
383,1371,257,23,142,949,1371
384,1382,265,18,145,954,1382
385,1392,273,25,137,957,1392
386,1396,275,27,134,960,1396
387,1400,280,27,128,965,1400
388,1407,292,28,119,968,1407
389,1419,303,24,118,974,1419
390,1418,313,22,112,971,1418
391,1420,313,24,112,971,1420
392,1434,327,23,109,975,1434
393,1446,334,30,105,977,1446
394,1450,338,32,104,976,1450
395,1466,354,30,106,976,1466
396,1480,371,24,108,977,1480
397,1483,382,22,101,978,1483
398,1491,390,23,100,978,1491
399,1495,383,33,103,976,1495
400,1500,387,39,100,974,1500
401,1499,386,38,101,974,1499
402,1500,385,38,108,969,1500
403,1497,388,29,111,969,1497
404,1500,389,30,113,968,1500
405,1500,385,40,112,963,1500
406,1500,381,38,118,963,1500
407,1500,378,37,123,962,1500
408,1499,377,36,124,962,1499
409,1499,380,28,127,964,1499
410,1500,378,30,129,963,1500
411,1500,378,34,129,959,1500
412,1500,383,33,126,958,1500
413,1500,378,32,132,958,1500
414,1500,374,38,136,952,1500
415,1500,371,40,138,951,1500
416,1500,367,45,136,952,1500
417,1500,370,44,131,955,1500
418,1500,366,42,138,954,1500
419,1500,362,40,146,952,1500
420,1500,355,45,144,956,1500
421,1497,350,44,147,956,1497
422,1500,350,46,147,957,1500
423,1498,351,47,147,953,1498
424,1500,351,35,155,959,1500
425,1500,351,36,155,958,1500
426,1500,342,34,165,959,1500
427,1500,340,38,160,962,1500
428,1500,338,39,162,961,1500
429,1498,329,43,163,963,1498
430,1500,328,41,166,965,1500
431,1500,321,45,167,967,1500
432,1497,317,54,159,967,1497
433,1500,313,51,164,972,1500
434,1499,313,47,165,974,1499
435,1500,312,44,165,979,1500
436,1500,315,31,175,979,1500
437,1500,314,29,174,983,1500
438,1500,312,32,162,994,1500
439,1500,310,34,163,993,1500
440,1500,316,40,151,993,1500
441,1500,312,43,155,990,1500
442,1499,311,36,160,992,1499
443,1499,308,38,159,994,1499
444,1500,313,37,157,993,1500
445,1500,316,36,156,992,1500
446,1500,311,40,155,994,1500
447,1500,312,36,153,999,1500
448,1497,311,41,151,994,1497
449,1500,315,42,146,997,1500
450,1500,320,40,140,1000,1500
451,1500,323,35,143,999,1500
452,1500,324,32,145,999,1500
453,1500,324,34,146,996,1500
454,1498,332,28,151,987,1498
455,1500,331,30,150,989,1500
456,1500,339,31,145,985,1500
457,1498,345,29,143,981,1498
458,1499,348,32,137,982,1499
459,1498,359,30,137,972,1498
460,1500,361,34,140,965,1500
461,1499,371,34,130,964,1499
462,1498,372,36,131,959,1498
463,1500,377,37,132,954,1500
464,1499,376,43,130,950,1499
465,1500,392,41,125,942,1500
466,1500,393,45,128,934,1500
467,1500,395,41,134,930,1500
468,1500,402,42,137,919,1500
469,1500,417,38,138,907,1500
470,1500,419,38,141,902,1500
471,1499,421,35,148,895,1499
472,1500,422,45,151,882,1500
473,1498,431,46,150,871,1498
474,1500,435,53,149,863,1500
475,1500,439,52,162,847,1500
476,1500,444,60,165,831,1500
477,1500,450,64,168,818,1500
478,1499,461,58,177,803,1499
479,1499,459,58,187,795,1499
480,1499,469,51,194,785,1499
481,1499,481,57,190,771,1499
482,1495,486,66,192,751,1495
483,1500,502,66,199,733,1500
484,1498,497,75,202,724,1498
485,1496,516,67,207,706,1496
486,1500,509,73,219,699,1500
487,1500,503,72,234,691,1500
488,1500,486,87,244,683,1500
489,1496,488,95,240,673,1496
490,1500,480,97,252,671,1500
491,1498,475,93,267,663,1498
492,1498,475,84,280,659,1498
493,1497,474,85,280,658,1497
494,1500,480,78,289,653,1500
495,1499,464,88,301,646,1499
496,1499,459,84,311,645,1499
497,1497,454,89,315,639,1497
498,1500,449,83,329,639,1500
499,1500,425,92,333,650,1500
500,1499,420,92,335,652,1499
501,1498,401,108,333,656,1498
502,1494,394,97,348,655,1494
503,1500,384,107,356,653,1500
504,1497,375,106,357,659,1497
505,1495,364,94,367,670,1495
506,1496,365,89,361,681,1496
507,1496,358,84,369,685,1496
508,1491,345,85,367,694,1491
509,1490,336,95,364,695,1490
510,1490,320,97,367,706,1490
511,1493,322,93,365,713,1493
512,1494,321,84,365,724,1494
513,1497,320,77,371,729,1497
514,1490,307,76,374,733,1490
515,1483,295,84,368,736,1483
516,1478,287,79,362,750,1478
517,1476,286,77,361,752,1476
518,1480,282,79,355,764,1480
519,1468,274,78,338,778,1468
520,1469,266,73,339,791,1469
521,1464,259,74,331,800,1464
522,1457,252,69,324,812,1457
523,1458,249,64,327,818,1458
524,1457,249,62,319,827,1457
525,1456,255,51,319,831,1456
526,1453,251,54,305,843,1453
527,1449,249,52,293,855,1449
528,1445,250,55,278,862,1445
529,1446,246,56,282,862,1446
530,1449,241,69,264,875,1449
531,1455,245,62,260,888,1455
532,1450,247,60,254,889,1450
533,1452,249,51,257,895,1452
534,1454,253,44,246,911,1454
535,1454,246,50,239,919,1454
536,1452,253,42,236,921,1452
537,1449,250,50,225,924,1449
538,1444,247,53,217,927,1444
539,1441,251,52,209,929,1441
540,1443,256,51,206,930,1443
541,1451,266,39,209,937,1451
542,1458,270,37,212,939,1458
543,1453,270,37,203,943,1453
544,1464,287,38,202,937,1464
545,1469,293,37,195,944,1469
546,1478,303,37,192,946,1478
547,1474,309,38,177,950,1474
548,1475,310,34,177,954,1475
549,1485,319,38,172,956,1485
550,1499,341,40,162,956,1499
551,1499,339,44,162,954,1499
552,1500,338,45,162,955,1500
553,1499,339,44,164,952,1499
554,1500,344,40,164,952,1500
555,1495,348,35,158,954,1495
556,1497,350,37,154,956,1497
557,1500,359,36,153,952,1500
558,1500,366,35,154,945,1500
559,1500,359,36,155,950,1500
560,1500,359,39,153,949,1500
561,1499,363,34,155,947,1499
562,1500,369,35,146,950,1500
563,1499,366,31,156,946,1499
564,1499,369,33,156,941,1499
565,1499,368,39,150,942,1499
566,1498,366,40,150,942,1498
567,1500,372,38,148,942,1500
568,1499,366,45,141,947,1499
569,1500,366,43,144,947,1500
570,1500,369,44,144,943,1500
571,1497,366,42,146,943,1497
572,1500,358,45,150,947,1500
573,1500,363,43,149,945,1500
574,1499,352,50,149,948,1499
575,1500,353,42,156,949,1500
576,1499,345,47,160,947,1499
577,1499,347,44,155,953,1499
578,1500,349,42,160,949,1500
579,1500,332,50,170,948,1500
580,1499,337,43,170,949,1499
581,1499,343,46,169,941,1499
582,1499,338,45,177,939,1499
583,1500,337,41,179,943,1500
584,1500,335,49,173,943,1500
585,1497,337,44,173,943,1497
586,1500,331,48,174,947,1500
587,1499,330,43,179,947,1499
588,1499,321,54,179,945,1499
589,1500,332,48,174,946,1500
590,1500,326,48,179,947,1500
591,1500,320,47,182,951,1500
592,1498,324,40,182,952,1498
593,1500,329,39,177,955,1500
594,1499,326,38,179,956,1499
595,1499,325,32,182,960,1499
596,1500,329,35,176,960,1500
597,1499,332,35,168,964,1499
598,1500,321,45,172,962,1500
599,1500,324,45,170,961,1500
600,1500,327,43,168,962,1500
601,1499,328,39,166,966,1499
602,1499,332,32,168,967,1499
603,1497,329,33,167,968,1497
604,1500,339,29,162,970,1500
605,1498,333,36,154,975,1498
606,1500,339,35,150,976,1500
607,1500,335,40,149,976,1500
608,1499,337,38,147,977,1499
609,1500,343,37,144,976,1500
610,1500,346,36,147,971,1500
611,1498,348,33,148,969,1498
612,1500,348,37,150,965,1500
613,1500,354,39,148,959,1500
614,1499,355,43,146,955,1499
615,1500,360,36,144,960,1500
616,1497,364,38,141,954,1497
617,1500,362,39,144,955,1500
618,1500,364,36,144,956,1500
619,1500,362,44,144,950,1500
620,1500,359,43,152,946,1500
621,1500,356,49,151,944,1500
622,1499,353,52,148,946,1499
623,1499,351,46,156,946,1499
624,1500,359,36,164,941,1500
625,1499,365,40,162,932,1499
626,1500,380,38,163,919,1500
627,1500,387,33,167,913,1500
628,1500,383,49,163,905,1500
629,1500,389,46,165,900,1500
630,1499,396,47,167,889,1499
631,1499,399,48,168,884,1499
632,1500,413,40,171,876,1500
633,1500,411,46,173,870,1500
634,1497,409,49,169,870,1497
635,1499,410,46,177,866,1499
636,1497,422,53,175,847,1497
637,1497,433,47,173,844,1497
638,1499,437,49,171,842,1499
639,1500,445,53,170,832,1500
640,1498,447,56,175,820,1498
641,1500,452,56,179,813,1500
642,1500,450,59,188,803,1500
643,1498,448,61,188,801,1498
644,1500,448,57,198,797,1500
645,1499,443,59,198,799,1499
646,1498,441,62,201,794,1498
647,1500,449,60,207,784,1500
648,1498,440,68,210,780,1498
649,1499,432,76,210,781,1499
650,1499,429,77,226,767,1499
651,1500,434,84,226,756,1500
652,1500,432,78,229,761,1500
653,1500,422,76,246,756,1500
654,1498,429,67,256,746,1498
655,1500,423,72,261,744,1500
656,1497,419,75,261,742,1497
657,1499,415,76,271,737,1499
658,1498,414,78,266,740,1498
659,1500,408,72,278,742,1500
660,1496,389,80,284,743,1496
661,1499,386,88,286,739,1499
662,1498,374,92,290,742,1498
663,1499,363,93,299,744,1499
664,1496,360,79,307,750,1496
665,1499,368,66,318,747,1499
666,1500,360,69,321,750,1500
667,1498,355,78,313,752,1498
668,1492,347,81,306,758,1492
669,1492,348,82,301,761,1492
670,1500,355,69,315,761,1500
671,1498,350,67,310,771,1498
672,1497,336,73,318,770,1497
673,1493,335,73,311,774,1493
674,1500,330,83,301,786,1500
675,1498,326,84,306,782,1498
676,1500,319,80,316,785,1500
677,1492,307,87,308,790,1492
678,1483,304,83,301,795,1483
679,1486,305,78,301,802,1486
680,1488,314,68,301,805,1488
681,1492,313,66,304,809,1492
682,1491,309,64,308,810,1491
683,1499,302,73,308,816,1499
684,1499,295,79,292,833,1499
685,1500,297,68,297,838,1500
686,1498,290,61,301,846,1498
687,1498,291,61,298,848,1498
688,1496,279,69,301,847,1496
689,1498,270,74,299,855,1498
690,1498,269,70,289,870,1498
691,1498,269,76,284,869,1498
692,1499,275,58,291,875,1499
693,1489,275,55,278,881,1489
694,1490,275,50,277,888,1490
695,1490,277,53,269,891,1490
696,1488,278,48,262,900,1488
697,1499,285,57,259,898,1499
698,1500,278,57,262,903,1500
699,1494,285,46,251,912,1494
700,1499,295,41,237,926,1499
701,1500,282,41,242,935,1500
702,1499,276,50,235,938,1499
703,1498,279,61,220,938,1498
704,1499,277,65,215,942,1499
705,1499,274,58,226,941,1499
706,1498,285,53,209,951,1498
707,1498,284,50,210,954,1498
708,1500,287,41,211,961,1500
709,1498,281,48,208,961,1498
710,1500,287,48,201,964,1500
711,1500,290,41,207,962,1500
712,1497,290,45,199,963,1497
713,1497,295,35,204,963,1497
714,1500,299,41,198,962,1500
715,1495,293,47,188,967,1495
716,1495,295,47,191,962,1495
717,1500,296,53,192,959,1500
718,1497,290,48,196,963,1497
719,1496,294,46,187,969,1496
720,1499,300,44,188,967,1499
721,1500,308,43,185,964,1500
722,1500,304,43,175,978,1500
723,1500,302,42,177,979,1500
724,1500,303,46,179,972,1500
725,1500,314,39,174,973,1500
726,1500,315,40,177,968,1500
727,1500,313,40,170,977,1500
728,1500,311,37,175,977,1500
729,1500,313,37,174,976,1500
730,1500,312,37,173,978,1500
731,1500,305,42,174,979,1500
732,1498,310,39,167,982,1498
733,1498,313,36,167,982,1498
734,1499,311,40,163,985,1499
735,1500,314,42,159,985,1500
736,1500,318,38,155,989,1500
737,1499,317,33,159,990,1499
738,1500,322,33,158,987,1500
739,1500,322,37,154,987,1500
740,1500,319,40,151,990,1500
741,1499,323,39,149,988,1499
742,1497,330,33,149,985,1497
743,1500,333,33,151,983,1500
744,1498,337,31,148,982,1498
745,1500,339,33,149,979,1500
746,1500,341,32,147,980,1500
747,1500,345,28,142,985,1500
748,1500,342,32,140,986,1500
749,1500,349,30,139,982,1500
750,1500,350,27,139,984,1500
751,1500,356,23,132,989,1500
752,1500,366,16,133,985,1500
753,1500,361,27,126,986,1500
754,1500,362,29,123,986,1500
755,1500,358,31,121,990,1500
756,1499,351,39,113,996,1499
757,1498,357,33,114,994,1498
758,1500,362,39,115,984,1500
759,1500,364,41,113,982,1500
760,1499,360,39,116,984,1499
761,1500,358,43,118,981,1500
762,1499,356,39,122,982,1499
763,1499,359,40,122,978,1499
764,1500,366,35,126,973,1500
765,1500,373,32,128,967,1500
766,1495,375,30,129,961,1495
767,1500,375,34,133,958,1500
768,1500,378,29,138,955,1500
769,1500,375,34,138,953,1500
770,1500,370,36,141,953,1500
771,1500,373,34,139,954,1500
772,1500,381,31,140,948,1500
773,1500,375,36,142,947,1500
774,1498,374,41,139,944,1498
775,1500,383,41,136,940,1500
776,1500,381,39,139,941,1500
777,1499,381,35,144,939,1499
778,1500,385,36,142,937,1500
779,1498,380,45,138,935,1498
780,1498,382,38,144,934,1498
781,1500,383,45,141,931,1500
782,1500,388,41,145,926,1500
783,1497,386,40,151,920,1497
784,1500,391,42,156,911,1500
785,1499,388,46,154,911,1499
786,1498,387,46,156,909,1498
787,1500,393,50,156,901,1500
788,1499,394,50,163,892,1499
789,1500,392,50,170,888,1500
790,1500,388,59,164,889,1500
791,1499,394,53,171,881,1499
792,1500,399,48,175,878,1500
793,1500,393,53,182,872,1500
794,1499,401,57,180,861,1499
795,1500,393,62,188,857,1500
796,1500,394,64,189,853,1500
797,1500,401,51,198,850,1500
798,1498,407,46,203,842,1498
799,1500,413,44,210,833,1500
800,1499,414,45,211,829,1499
801,1499,409,56,212,822,1499
802,1500,409,58,209,824,1500
803,1499,405,59,207,828,1499
804,1500,408,61,216,815,1500
805,1499,406,67,212,814,1499
806,1500,403,71,218,808,1500
807,1498,411,60,224,803,1498
808,1497,405,68,222,802,1497
809,1496,411,56,239,790,1496
810,1500,420,60,239,781,1500
811,1500,417,70,227,786,1500
812,1497,417,67,230,783,1497
813,1497,415,66,231,785,1497
814,1500,406,76,237,781,1500
815,1500,406,72,247,775,1500
816,1500,398,77,256,769,1500
817,1500,389,82,260,769,1500
818,1499,386,80,262,771,1499
819,1498,387,74,272,765,1498
820,1498,391,75,273,759,1498
821,1492,381,79,278,754,1492
822,1491,367,91,280,753,1491
823,1489,366,93,270,760,1489
824,1489,371,75,288,755,1489
825,1495,358,84,297,756,1495
826,1495,372,71,304,748,1495
827,1498,369,80,300,749,1498
828,1499,369,75,309,746,1499
829,1499,362,77,314,746,1499
830,1499,363,77,312,747,1499
831,1499,354,78,317,750,1499
832,1496,333,90,317,756,1496
833,1499,332,89,314,764,1499
834,1500,329,83,315,773,1500
835,1496,326,73,319,778,1496
836,1497,315,72,326,784,1497
837,1499,301,73,331,794,1499
838,1489,292,81,314,802,1489
839,1489,292,83,314,800,1489
840,1495,300,79,308,808,1495
841,1496,297,70,323,806,1496
842,1495,303,77,313,802,1495
843,1500,302,76,312,810,1500
844,1498,285,88,308,817,1498
845,1491,285,78,312,816,1491
846,1484,277,76,312,819,1484
847,1494,293,69,314,818,1494
848,1497,292,65,314,826,1497
849,1497,284,75,301,837,1497
850,1492,277,73,299,843,1492
851,1490,269,78,294,849,1490
852,1498,270,83,296,849,1498
853,1498,278,68,301,851,1498
854,1499,281,57,307,854,1499
855,1493,286,57,296,854,1493
856,1500,292,53,299,856,1500
857,1498,291,57,287,863,1498
858,1500,287,65,284,864,1500
859,1497,285,64,275,873,1497
860,1490,279,65,272,874,1490
861,1490,279,64,265,882,1490
862,1495,273,70,262,890,1495
863,1500,276,67,263,894,1500
864,1497,276,61,260,900,1497
865,1499,272,57,265,905,1499
866,1500,269,53,267,911,1500
867,1499,280,56,251,912,1499
868,1496,277,61,242,916,1496
869,1500,276,56,244,924,1500
870,1500,272,65,234,929,1500
871,1500,276,61,240,923,1500
872,1498,271,53,248,926,1498
873,1499,276,44,247,932,1499
874,1494,273,44,244,933,1494
875,1500,284,44,238,934,1500
876,1499,285,46,232,936,1499
877,1499,283,50,225,941,1499
878,1500,287,45,221,947,1500
879,1498,285,46,209,958,1498
880,1496,288,36,209,963,1496
881,1500,284,39,211,966,1500
882,1492,277,46,200,969,1492
883,1491,282,42,193,974,1491
884,1496,289,42,190,975,1496
885,1495,300,27,191,977,1495
886,1497,299,33,178,987,1497
887,1499,299,35,172,993,1499
888,1500,298,40,164,998,1500
889,1500,296,43,162,999,1500
890,1498,293,44,160,1001,1498
891,1500,301,42,160,997,1500
892,1498,294,38,163,1003,1498
893,1498,300,30,165,1003,1498
894,1495,303,34,152,1006,1495
895,1499,306,34,153,1006,1499
896,1500,307,36,154,1003,1500
897,1499,313,34,149,1003,1499
898,1500,316,34,152,998,1500
899,1498,320,31,145,1002,1498
900,1498,324,31,146,997,1498
901,1498,320,35,144,999,1498
902,1500,326,31,148,995,1500
903,1499,322,35,146,996,1499
904,1500,323,35,143,999,1500
905,1498,327,31,143,997,1498
906,1498,329,32,137,1000,1498
907,1499,333,32,132,1002,1499
908,1500,331,36,132,1001,1500
909,1500,331,38,129,1002,1500
910,1500,331,40,133,996,1500
911,1500,328,41,135,996,1500
912,1498,331,38,134,995,1498
913,1499,334,32,136,997,1499
914,1500,340,27,137,996,1500
915,1499,338,26,137,998,1499
916,1500,343,26,137,994,1500
917,1499,343,32,133,991,1499
918,1500,337,36,132,995,1500
919,1500,339,36,129,996,1500
920,1500,339,32,133,996,1500
921,1497,330,36,132,999,1497
922,1498,335,35,138,990,1498
923,1500,343,41,134,982,1500
924,1500,342,40,134,984,1500
925,1499,345,45,132,977,1499
926,1499,351,36,137,975,1499
927,1498,355,32,134,977,1498
928,1500,353,35,135,977,1500
929,1499,346,35,139,979,1499
930,1500,350,39,133,978,1500
931,1500,358,30,144,968,1500
932,1500,360,32,145,963,1500
933,1500,365,32,147,956,1500
934,1499,367,35,142,955,1499
935,1499,366,37,144,952,1499
936,1499,365,47,137,950,1499
937,1500,365,47,144,944,1500
938,1495,365,50,142,938,1495
939,1499,370,47,148,934,1499
940,1500,377,40,155,928,1500
941,1500,374,45,151,930,1500
942,1499,368,48,151,932,1499
943,1498,383,42,152,921,1498
944,1499,376,41,163,919,1499
945,1500,367,47,160,926,1500
946,1500,366,52,162,920,1500
947,1500,367,53,165,915,1500
948,1500,369,52,170,909,1500
949,1499,368,46,181,904,1499
950,1499,372,44,187,896,1499
951,1499,381,44,184,890,1499
952,1500,385,38,192,885,1500
953,1498,389,39,192,878,1498
954,1496,399,44,179,874,1496
955,1500,410,46,179,865,1500
956,1500,402,52,181,865,1500
957,1500,409,50,184,857,1500
958,1499,412,56,178,853,1499
959,1495,417,51,180,847,1495
960,1495,429,43,187,836,1495
961,1496,428,45,189,834,1496
962,1500,440,42,189,829,1500
963,1498,448,49,176,825,1498
964,1500,456,44,176,824,1500
965,1499,450,45,184,820,1499
966,1496,446,51,178,821,1496
967,1500,453,60,174,813,1500
968,1500,452,65,176,807,1500
969,1500,447,70,187,796,1500
970,1500,449,59,199,793,1500
971,1500,455,58,199,788,1500
972,1499,455,52,210,782,1499
973,1499,451,52,215,781,1499
974,1500,459,51,210,780,1500
975,1499,454,60,209,776,1499
976,1500,446,64,211,779,1500
977,1500,444,71,220,765,1500
978,1500,432,81,222,765,1500
979,1500,442,74,223,761,1500
980,1498,435,66,238,759,1498
981,1500,431,67,250,752,1500
982,1498,437,60,259,742,1498
983,1497,434,69,253,741,1497
984,1493,438,67,251,737,1493
985,1499,433,75,253,738,1499
986,1498,435,77,250,736,1498
987,1500,433,82,249,736,1500
988,1500,430,81,260,729,1500
989,1500,427,75,270,728,1500
990,1499,425,70,276,728,1499
991,1498,416,71,281,730,1498
992,1499,405,74,291,729,1499
993,1497,394,88,289,726,1497
994,1491,386,93,281,731,1491
995,1490,375,95,285,735,1490
996,1490,375,91,288,736,1490
997,1492,366,88,307,731,1492
998,1496,364,82,313,737,1496
999,1496,368,81,315,732,1496
1000,1500,365,79,322,734,1500
1001,1496,356,74,330,736,1496
1002,1495,341,86,326,742,1495
1003,1493,345,79,325,744,1493
1004,1496,337,82,321,756,1496
1005,1493,334,71,327,761,1493
1006,1493,332,67,327,767,1493
1007,1493,335,67,326,765,1493
1008,1494,332,64,330,768,1494
1009,1498,333,73,320,772,1498
1010,1499,333,66,321,779,1499
1011,1491,322,74,305,790,1491
1012,1492,331,66,299,796,1492
1013,1491,327,67,297,800,1491
1014,1493,319,69,298,807,1493
1015,1490,314,74,287,815,1490
1016,1489,305,78,287,819,1489
1017,1495,313,74,284,824,1495
1018,1493,299,68,294,832,1493
1019,1489,305,65,282,837,1489
1020,1488,293,68,280,847,1488
1021,1488,288,69,284,847,1488
1022,1480,278,71,277,854,1480
1023,1489,283,65,282,859,1489
1024,1495,282,63,281,869,1495
1025,1499,284,59,284,872,1499
1026,1493,276,69,275,873,1493
1027,1490,272,66,279,873,1490
1028,1497,275,70,268,884,1497
1029,1500,285,58,273,884,1500
1030,1498,274,58,275,891,1498
1031,1500,270,62,275,893,1500
1032,1494,273,58,259,904,1494
1033,1495,279,51,259,906,1495
1034,1497,281,42,261,913,1497
1035,1498,281,42,257,918,1498
1036,1500,272,53,248,927,1500
1037,1500,271,56,237,936,1500
1038,1499,277,49,230,943,1499
1039,1498,280,44,229,945,1498
1040,1500,278,46,231,945,1500
1041,1498,281,45,221,951,1498
1042,1500,277,51,215,957,1500
1043,1500,281,43,212,964,1500
1044,1496,284,41,205,966,1496
1045,1498,288,45,194,971,1498
1046,1499,286,43,195,975,1499
1047,1499,293,39,191,976,1499
1048,1496,291,40,182,983,1496
1049,1498,295,44,175,984,1498
1050,1500,300,42,181,977,1500
1051,1500,296,44,179,981,1500
1052,1500,295,43,178,984,1500
1053,1500,293,45,173,989,1500
1054,1500,291,52,167,990,1500
1055,1500,289,49,166,996,1500
1056,1500,284,45,174,997,1500
1057,1499,280,41,173,1005,1499
1058,1500,282,40,170,1008,1500
1059,1500,278,35,174,1013,1500
1060,1498,276,37,172,1013,1498
1061,1500,280,37,172,1011,1500
1062,1497,282,43,162,1010,1497
1063,1500,288,32,171,1009,1500
1064,1500,287,31,169,1013,1500
1065,1500,298,30,169,1003,1500
1066,1500,300,31,162,1007,1500
1067,1500,300,30,161,1009,1500
1068,1499,297,33,158,1011,1499
1069,1497,287,41,156,1013,1497
1070,1499,291,36,151,1021,1499
1071,1497,292,39,140,1026,1497
1072,1496,293,33,145,1025,1496
1073,1499,298,32,145,1024,1499
1074,1500,313,30,141,1016,1500
1075,1497,311,33,136,1017,1497
1076,1500,321,25,144,1010,1500
1077,1500,324,28,133,1015,1500
1078,1499,327,28,131,1013,1499
1079,1500,327,28,129,1016,1500
1080,1499,321,31,129,1018,1499
1081,1500,323,30,127,1020,1500
1082,1500,329,27,129,1015,1500
1083,1498,334,29,126,1009,1498
1084,1499,341,23,126,1009,1499
1085,1500,342,25,127,1006,1500
1086,1500,346,29,117,1008,1500
1087,1500,348,27,113,1012,1500
1088,1500,351,27,111,1011,1500
1089,1500,351,24,116,1009,1500
1090,1500,360,24,109,1007,1500
1091,1499,362,28,107,1002,1499
1092,1500,365,24,108,1003,1500
1093,1499,363,28,109,999,1499
1094,1500,372,26,109,993,1500
1095,1499,373,23,108,995,1499
1096,1500,384,23,104,989,1500
1097,1500,379,24,106,991,1500
1098,1498,380,28,101,989,1498
1099,1500,386,30,103,981,1500
1100,1500,389,35,100,976,1500
1101,1500,385,35,104,976,1500
1102,1500,385,34,106,975,1500
1103,1500,390,35,103,972,1500
1104,1500,391,32,109,968,1500
1105,1499,393,33,114,959,1499
1106,1499,396,33,113,957,1499
1107,1500,403,32,115,950,1500
1108,1500,395,40,115,950,1500
1109,1500,402,37,117,944,1500
1110,1500,411,31,124,934,1500
1111,1500,407,38,126,929,1500
1112,1499,401,43,129,926,1499
1113,1500,403,49,127,921,1500
1114,1500,406,49,136,909,1500
1115,1500,411,43,142,904,1500
1116,1500,415,42,144,899,1500
1117,1498,411,41,148,898,1498
1118,1497,420,41,150,886,1497
1119,1499,421,44,150,884,1499
1120,1500,428,45,152,875,1500
1121,1500,424,50,155,871,1500
1122,1498,425,52,160,861,1498
1123,1499,426,51,165,857,1499
1124,1500,427,59,165,849,1500
1125,1500,430,57,171,842,1500
1126,1500,433,60,177,830,1500
1127,1500,423,63,187,827,1500
1128,1498,417,68,191,822,1498
1129,1497,423,66,189,819,1497
1130,1500,427,60,202,811,1500
1131,1500,428,60,207,805,1500
1132,1500,436,58,209,797,1500
1133,1500,429,62,218,791,1500
1134,1500,425,71,221,783,1500
1135,1500,429,70,229,772,1500
1136,1498,417,82,229,770,1498
1137,1500,404,86,240,770,1500
1138,1499,400,87,250,762,1499
1139,1499,398,90,256,755,1499
1140,1500,392,88,267,753,1500
1141,1498,385,82,277,754,1498
1142,1500,371,87,285,757,1500
1143,1499,364,82,292,761,1499
1144,1496,354,91,293,758,1496
1145,1500,341,101,301,757,1500
1146,1500,331,106,305,758,1500
1147,1500,321,103,313,763,1500
1148,1500,320,97,330,753,1500
1149,1500,306,92,342,760,1500
1150,1500,308,85,350,757,1500
1151,1493,299,77,354,763,1493
1152,1495,299,81,357,758,1495
1153,1495,289,89,355,762,1495
1154,1498,292,92,348,766,1498
1155,1494,287,86,351,770,1494
1156,1494,297,76,351,770,1494
1157,1495,305,61,358,771,1495
1158,1499,310,68,350,771,1499
1159,1494,304,67,350,773,1494
1160,1495,293,83,340,779,1495
1161,1495,300,75,336,784,1495
1162,1487,292,71,332,792,1487
1163,1484,288,79,317,800,1484
1164,1481,283,80,319,799,1481
1165,1486,296,76,309,805,1486
1166,1478,296,69,307,806,1478
1167,1478,294,63,313,808,1478
1168,1477,294,65,312,806,1477
1169,1468,290,69,298,811,1468
1170,1468,288,65,293,822,1468
1171,1465,287,63,282,833,1465
1172,1467,287,61,288,831,1467
1173,1458,281,68,278,831,1458
1174,1462,276,69,288,829,1462
1175,1464,278,72,279,835,1464
1176,1464,287,63,272,842,1464
1177,1467,295,52,278,842,1467
1178,1474,303,48,271,852,1474
1179,1472,300,51,268,853,1472
1180,1474,307,50,257,860,1474
1181,1480,312,56,244,868,1480
1182,1481,315,53,242,871,1481
1183,1489,323,53,241,872,1489
1184,1494,325,59,235,875,1494
1185,1500,330,52,234,884,1500
1186,1495,328,55,225,887,1495
1187,1497,332,52,226,887,1497
1188,1500,336,47,221,896,1500
1189,1500,330,50,224,896,1500
1190,1496,335,45,217,899,1496
1191,1499,341,50,205,903,1499
1192,1498,340,50,203,905,1498
1193,1499,342,49,202,906,1499
1194,1499,339,45,206,909,1499
1195,1500,336,53,203,908,1500
1196,1498,330,55,198,915,1498
1197,1499,338,53,199,909,1499
1198,1498,341,48,202,907,1498
1199,1500,333,54,201,912,1500
1200,1500,329,51,204,916,1500
1201,1497,330,54,196,917,1497
1202,1497,329,46,200,922,1497
1203,1498,334,45,196,923,1498
1204,1500,327,49,202,922,1500
1205,1500,324,47,202,927,1500
1206,1500,323,54,200,923,1500
1207,1499,324,50,201,924,1499
1208,1500,325,51,198,926,1500
1209,1500,319,54,201,926,1500
1210,1498,314,51,206,927,1498
1211,1500,311,53,202,934,1500
1212,1494,308,47,204,935,1494
1213,1494,308,47,199,940,1494
1214,1498,312,42,201,943,1498
1215,1500,313,42,204,941,1500
1216,1500,309,46,198,947,1500
1217,1499,295,53,198,953,1499
1218,1500,302,50,191,957,1500
1219,1500,291,50,197,962,1500
1220,1499,285,46,200,968,1499
1221,1500,283,48,197,972,1500
1222,1499,277,53,195,974,1499
1223,1498,278,49,197,974,1498
1224,1500,280,48,194,978,1500
1225,1500,276,46,198,980,1500
1226,1494,278,44,193,979,1494
1227,1500,283,42,193,982,1500
1228,1500,295,32,190,983,1500
1229,1499,286,40,187,986,1499
1230,1500,281,40,186,993,1500
1231,1499,278,44,182,995,1499
1232,1499,277,38,184,1000,1499
1233,1500,288,33,178,1001,1500
1234,1499,280,35,175,1009,1499
1235,1500,282,40,169,1009,1500
1236,1499,285,40,165,1009,1499
1237,1498,279,41,165,1013,1498
1238,1497,280,37,163,1017,1497
1239,1500,287,36,158,1019,1500
1240,1497,285,39,154,1019,1497
1241,1500,287,36,155,1022,1500
1242,1499,293,29,150,1027,1499
1243,1500,300,26,150,1024,1500
1244,1498,304,20,152,1022,1498
1245,1500,300,26,149,1025,1500
1246,1500,302,31,138,1029,1500
1247,1499,298,36,135,1030,1499
1248,1500,303,35,134,1028,1500
1249,1499,305,35,136,1023,1499
1250,1500,305,36,136,1023,1500
1251,1500,319,30,134,1017,1500
1252,1500,322,31,131,1016,1500
1253,1499,320,34,130,1015,1499
1254,1499,323,36,128,1012,1499
1255,1500,322,38,124,1016,1500
1256,1500,322,37,124,1017,1500
1257,1500,330,34,126,1010,1500
1258,1499,335,28,124,1012,1499
1259,1500,345,24,127,1004,1500
1260,1500,342,27,135,996,1500
1261,1500,341,35,130,994,1500
1262,1500,349,37,125,989,1500
1263,1499,354,32,129,984,1499
1264,1499,361,30,132,976,1499
1265,1498,367,28,127,976,1498
1266,1500,374,29,126,971,1500
1267,1500,379,27,128,966,1500
1268,1500,380,26,128,966,1500
1269,1500,386,32,126,956,1500
1270,1499,387,34,124,954,1499
1271,1500,406,33,118,943,1500
1272,1499,413,28,117,941,1499
1273,1499,424,24,119,932,1499
1274,1500,439,25,118,918,1500
1275,1500,445,25,123,907,1500
1276,1500,447,36,119,898,1500
1277,1499,458,41,111,889,1499
1278,1499,462,43,114,880,1499
1279,1500,466,47,114,873,1500
1280,1500,463,48,120,869,1500
1281,1499,472,48,122,857,1499
1282,1500,478,48,131,843,1500
1283,1500,484,59,131,826,1500
1284,1500,484,56,140,820,1500
1285,1500,481,61,151,807,1500
1286,1500,481,60,157,802,1500
1287,1500,483,56,164,797,1500
1288,1500,482,59,169,790,1500
1289,1500,476,61,181,782,1500
1290,1499,473,61,195,770,1499
1291,1500,479,58,207,756,1500
1292,1498,467,65,208,758,1498
1293,1500,463,59,224,754,1500
1294,1499,451,71,225,752,1499
1295,1498,443,79,232,744,1498
1296,1500,449,77,234,740,1500
1297,1500,445,75,244,736,1500
1298,1499,448,70,255,726,1499
1299,1499,449,64,261,725,1499
1300,1498,446,72,261,719,1498
1301,1500,442,79,266,713,1500
1302,1500,438,84,268,710,1500
1303,1499,432,84,267,716,1499
1304,1498,428,80,277,713,1498
1305,1497,418,86,281,712,1497
1306,1500,420,77,294,709,1500
1307,1500,408,87,289,716,1500
1308,1495,404,82,302,707,1495
1309,1498,387,98,298,715,1498
1310,1499,386,90,309,714,1499
1311,1500,387,89,315,709,1500
1312,1496,382,79,322,713,1496
1313,1500,371,90,318,721,1500
1314,1499,361,87,326,725,1499
1315,1497,342,93,328,734,1497
1316,1496,338,85,339,734,1496
1317,1495,332,82,341,740,1495
1318,1495,319,91,338,747,1495
1319,1497,318,85,347,747,1497
1320,1495,313,94,336,752,1495
1321,1496,314,79,348,755,1496
1322,1491,319,64,348,760,1491
1323,1489,311,64,352,762,1489
1324,1490,305,65,344,776,1490
1325,1491,303,70,336,782,1491
1326,1486,301,67,323,795,1486
1327,1488,300,72,321,795,1488
1328,1480,291,70,322,797,1480
1329,1479,297,70,310,802,1479
1330,1477,299,65,304,809,1477
1331,1477,298,60,306,813,1477
1332,1471,292,63,299,817,1471
1333,1472,297,63,285,827,1472
1334,1478,307,60,285,826,1478
1335,1478,309,63,271,835,1478
1336,1482,319,56,267,840,1482
1337,1487,320,66,259,842,1487
1338,1495,329,70,252,844,1495
1339,1500,334,59,262,845,1500
1340,1499,336,63,252,848,1499
1341,1500,341,55,258,846,1500
1342,1491,331,60,250,850,1491
1343,1494,330,62,252,850,1494
1344,1493,328,66,248,851,1493
1345,1488,332,58,242,856,1488
1346,1489,328,61,244,856,1489
1347,1499,339,55,246,859,1499
1348,1499,335,56,247,861,1499
1349,1496,331,61,243,861,1496
1350,1497,331,64,236,866,1497
1351,1498,327,66,241,864,1498
1352,1500,331,61,243,865,1500
1353,1496,333,56,236,871,1496
1354,1495,333,49,246,867,1495
1355,1492,331,53,239,869,1492
1356,1500,332,61,231,876,1500
1357,1497,325,67,230,875,1497
1358,1496,331,58,234,873,1496
1359,1500,336,57,233,874,1500
1360,1498,333,54,235,876,1498
1361,1500,338,52,231,879,1500
1362,1500,332,53,231,884,1500
1363,1500,331,52,232,885,1500
1364,1500,322,53,230,895,1500
1365,1497,320,54,229,894,1497
1366,1499,324,57,226,892,1499
1367,1500,323,59,219,899,1500
1368,1495,324,49,219,903,1495
1369,1499,319,51,220,909,1499
1370,1499,307,52,226,914,1499
1371,1500,307,54,222,917,1500
1372,1500,305,63,215,917,1500
1373,1500,299,56,221,924,1500
1374,1499,296,59,213,931,1499
1375,1500,295,56,214,935,1500
1376,1499,300,46,219,934,1499
1377,1500,288,49,222,941,1500
1378,1499,296,42,221,940,1499
1379,1497,291,48,214,944,1497
1380,1499,288,46,217,948,1499
1381,1500,284,48,219,949,1500
1382,1495,284,52,206,953,1495
1383,1498,289,48,207,954,1498
1384,1500,290,45,205,960,1500
1385,1500,290,44,208,958,1500
1386,1500,293,40,206,961,1500
1387,1500,293,38,198,971,1500
1388,1500,289,41,196,974,1500
1389,1498,286,41,194,977,1498
1390,1494,288,45,181,980,1494
1391,1499,295,41,176,987,1499
1392,1500,301,37,175,987,1500
1393,1500,301,33,178,988,1500
1394,1500,293,40,173,994,1500
1395,1500,285,44,171,1000,1500
1396,1500,290,40,170,1000,1500
1397,1497,290,42,163,1002,1497
1398,1499,294,32,167,1006,1499
1399,1500,292,32,166,1010,1500
1400,1500,294,35,159,1012,1500
1401,1496,292,34,156,1014,1496
1402,1500,300,26,157,1017,1500
1403,1499,305,23,149,1022,1499
1404,1500,299,23,152,1026,1500
1405,1500,297,29,145,1029,1500
1406,1500,305,30,137,1028,1500
1407,1500,307,31,131,1031,1500
1408,1499,308,24,132,1035,1499
1409,1500,312,23,129,1036,1500
1410,1500,308,25,128,1039,1500
1411,1500,304,26,124,1046,1500
1412,1499,309,31,112,1047,1499
1413,1500,313,31,107,1049,1500
1414,1500,310,27,112,1051,1500
1415,1500,308,28,111,1053,1500
1416,1499,314,29,106,1050,1499
1417,1500,313,30,108,1049,1500
1418,1500,322,24,105,1049,1500
1419,1500,332,15,109,1044,1500
1420,1500,334,17,110,1039,1500
1421,1500,342,12,111,1035,1500
1422,1500,343,21,101,1035,1500
1423,1500,352,22,98,1028,1500
1424,1500,354,26,95,1025,1500
1425,1500,364,24,94,1018,1500
1426,1500,363,25,96,1016,1500
1427,1499,373,23,100,1003,1499
1428,1499,378,25,94,1002,1499
1429,1499,387,27,89,996,1499
1430,1500,399,24,91,986,1500
1431,1500,409,21,90,980,1500
1432,1499,414,23,90,972,1499
1433,1500,425,25,86,964,1500
1434,1500,424,33,86,957,1500
1435,1500,436,36,84,944,1500
1436,1500,440,33,91,936,1500
1437,1499,443,31,98,927,1499
1438,1500,453,27,105,915,1500
1439,1500,461,25,108,906,1500
