ticks,turtles,healthy turtles,exposed turtles,infected turtles,immune turtles,masked turtles
0,1500,1490,10,0,0,1500
1,1500,1490,10,0,0,1500
2,1500,1490,10,0,0,1500
3,1500,1484,6,10,0,1500
4,1500,1480,10,10,0,1500
5,1500,1474,16,10,0,1500
6,1500,1470,16,14,0,1500
7,1500,1462,20,18,0,1500
8,1500,1450,26,24,0,1500
9,1500,1427,45,28,0,1500
10,1500,1402,65,33,0,1500
11,1500,1374,83,43,0,1500
12,1500,1346,92,62,0,1500
13,1500,1302,118,80,0,1500
14,1500,1253,139,108,0,1500
15,1500,1202,161,137,0,1500
16,1500,1142,186,172,0,1500
17,1500,1087,202,207,4,1500
18,1500,1026,209,261,4,1500
19,1500,951,224,321,4,1500
20,1500,882,245,369,4,1500
21,1500,798,263,432,7,1500
22,1500,729,272,489,10,1500
23,1500,650,273,566,11,1500
24,1499,593,258,636,12,1499
25,1497,546,232,705,14,1497
26,1498,520,202,754,22,1498
27,1494,459,186,816,33,1494
28,1482,413,180,844,45,1482
29,1476,371,176,865,64,1476
30,1464,333,176,871,84,1464
31,1446,294,157,892,103,1446
32,1422,270,136,886,130,1422
33,1398,243,127,868,160,1398
34,1377,217,120,853,187,1377
35,1351,187,112,830,222,1351
36,1327,172,109,793,253,1327
37,1288,158,93,745,292,1288
38,1259,147,85,696,331,1259
39,1219,128,68,656,367,1219
40,1184,111,70,606,397,1184
41,1150,104,65,545,436,1150
42,1125,98,62,505,460,1125
43,1101,85,56,477,483,1101
44,1083,79,52,453,499,1083
45,1057,77,47,404,529,1057
46,1048,76,48,368,556,1048
47,1029,74,38,342,575,1029
48,1016,74,34,315,593,1016
49,998,73,24,288,613,998
50,993,74,23,271,625,993
51,984,72,31,241,640,984
52,981,74,33,220,654,981
53,966,76,29,190,671,966
54,961,76,26,181,678,961
55,956,78,20,171,687,956
56,957,82,16,163,696,957
57,954,84,14,147,709,954
58,955,92,10,135,718,955
59,954,98,10,120,726,954
60,957,105,6,112,734,957
61,959,111,6,100,742,959
62,965,118,7,92,748,965
63,965,119,13,75,758,965
64,967,120,17,66,764,967
65,972,126,15,67,764,972
66,978,131,13,66,768,978
67,982,136,12,63,771,982
68,985,139,12,58,776,985
69,987,141,15,51,780,987
70,994,150,14,46,784,994
71,997,155,11,44,787,997
72,1007,162,12,43,790,1007
73,1015,169,10,46,790,1015
74,1019,170,13,43,793,1019
75,1030,180,15,41,794,1030
76,1036,186,11,45,794,1036
77,1046,191,14,47,794,1046
78,1059,200,12,53,794,1059
79,1068,207,16,50,795,1068
80,1072,209,18,49,796,1072
81,1075,214,14,49,798,1075
82,1088,224,15,50,799,1088
83,1094,228,13,53,800,1094
84,1103,234,13,54,802,1103
85,1113,238,18,51,806,1113
86,1121,242,17,52,810,1121
87,1125,245,20,50,810,1125
88,1126,244,17,55,810,1126
89,1131,248,13,60,810,1131
90,1137,255,12,57,813,1137
91,1146,258,15,60,813,1146
92,1157,266,18,57,816,1157
93,1163,268,20,59,816,1163
94,1172,277,19,59,817,1172
95,1177,276,19,62,820,1177
96,1182,278,19,63,822,1182
97,1194,285,24,60,825,1194
98,1208,295,23,62,828,1208
99,1215,296,22,68,829,1215
100,1225,301,22,70,832,1225
101,1237,306,26,72,833,1237
102,1247,313,26,73,835,1247
103,1258,317,28,73,840,1258
104,1273,324,31,76,842,1273
105,1282,328,30,80,844,1282
106,1300,339,31,85,845,1300
107,1311,334,41,89,847,1311
108,1319,334,40,96,849,1319
109,1328,332,44,97,855,1328
110,1343,336,49,100,858,1343
111,1356,336,50,111,859,1356
112,1361,329,50,119,863,1361
113,1372,315,61,127,869,1372
114,1381,310,69,131,871,1381
115,1394,307,75,140,872,1394
116,1404,296,76,157,875,1404
117,1409,291,71,170,877,1409
118,1417,284,70,183,880,1417
119,1424,268,73,196,887,1424
120,1431,268,66,207,890,1431
121,1442,265,66,216,895,1442
122,1445,253,63,229,900,1445
123,1458,252,62,239,905,1458
124,1468,239,75,243,911,1468
125,1476,237,74,249,916,1476
126,1485,235,75,253,922,1485
127,1485,226,71,259,929,1485
128,1492,214,73,270,935,1492
129,1497,209,71,273,944,1497
130,1493,205,59,275,954,1493
131,1498,193,65,274,966,1498
132,1499,178,70,273,978,1499
133,1498,175,67,269,987,1498
134,1492,163,67,268,994,1492
135,1500,165,57,273,1005,1500
136,1490,158,51,266,1015,1490
137,1498,156,54,264,1024,1498
138,1498,151,52,267,1028,1498
139,1498,145,55,260,1038,1498
140,1500,141,50,262,1047,1500
141,1500,143,45,254,1058,1500
142,1495,131,51,245,1068,1495
143,1496,129,48,245,1074,1496
144,1491,131,45,230,1085,1491
145,1498,139,45,223,1091,1498
146,1499,146,36,222,1095,1499
147,1497,156,37,214,1090,1497
148,1500,161,41,208,1090,1500
149,1499,173,48,195,1083,1499
150,1499,186,56,187,1070,1499
151,1498,199,53,186,1060,1498
152,1500,220,57,182,1041,1500
153,1500,242,56,187,1015,1500
154,1497,254,63,183,997,1497
155,1500,276,66,185,973,1500
156,1500,284,82,186,948,1500
157,1495,303,83,191,918,1495
158,1500,323,89,202,886,1500
159,1499,346,89,212,852,1499
160,1500,356,93,219,832,1500
161,1500,360,102,237,801,1500
162,1500,356,111,247,786,1500
163,1500,341,125,265,769,1500
164,1500,335,122,285,758,1500
165,1495,332,122,309,732,1495
166,1500,322,139,326,713,1500
167,1499,316,128,353,702,1499
168,1499,305,135,367,692,1499
169,1498,298,130,391,679,1498
170,1498,270,139,414,675,1498
171,1498,267,131,430,670,1498
172,1499,253,130,445,671,1499
173,1494,233,135,462,664,1494
174,1492,209,137,475,671,1492
175,1487,183,152,475,677,1487
176,1480,171,138,497,674,1480
177,1472,159,125,516,672,1472
178,1469,142,119,526,682,1469
179,1456,126,107,526,697,1456
180,1450,122,95,529,704,1450
181,1437,116,90,510,721,1437
182,1432,105,81,514,732,1432
183,1419,109,68,501,741,1419
184,1410,110,70,481,749,1410
185,1399,108,60,466,765,1399
186,1388,97,58,454,779,1388
187,1370,95,63,424,788,1370
188,1358,89,64,406,799,1358
189,1355,89,62,393,811,1355
190,1346,93,51,369,833,1346
191,1340,86,55,340,859,1340
192,1329,92,47,317,873,1329
193,1312,89,43,291,889,1312
194,1305,93,37,272,903,1305
195,1296,91,29,263,913,1296
196,1282,86,31,238,927,1282
197,1288,91,31,219,947,1288
198,1284,91,31,210,952,1284
199,1284,93,33,196,962,1284
200,1284,101,29,180,974,1284
201,1290,108,24,182,976,1290
202,1294,117,23,169,985,1294
203,1294,118,25,161,990,1294
204,1297,122,25,149,1001,1297
205,1299,134,23,137,1005,1299
206,1309,146,20,130,1013,1309
207,1323,159,20,124,1020,1323
208,1324,151,31,116,1026,1324
209,1330,155,34,104,1037,1330
210,1336,165,33,100,1038,1336
211,1343,168,27,106,1042,1343
212,1349,175,25,108,1041,1349
213,1357,182,24,106,1045,1357
214,1363,185,25,103,1050,1363
215,1363,190,25,97,1051,1363
216,1372,194,22,101,1055,1372
217,1387,206,22,102,1057,1387
218,1392,208,29,99,1056,1392
219,1404,212,31,103,1058,1404
220,1414,224,32,98,1060,1414
221,1425,237,24,101,1063,1425
222,1428,236,20,108,1064,1428
223,1440,240,28,109,1063,1440
224,1450,242,34,110,1064,1450
225,1456,254,35,100,1067,1456
226,1466,262,35,100,1069,1466
227,1476,260,36,109,1071,1476
228,1479,255,41,111,1072,1479
229,1488,264,42,114,1068,1488
230,1495,270,39,117,1069,1495
231,1499,264,43,119,1073,1499
232,1500,260,43,125,1072,1500
233,1500,260,42,130,1068,1500
234,1499,254,38,139,1068,1499
235,1499,248,38,140,1073,1499
236,1500,248,38,137,1077,1500
237,1500,237,42,142,1079,1500
238,1500,232,39,150,1079,1500
239,1498,225,41,158,1074,1498
240,1500,219,49,153,1079,1500
241,1498,220,47,152,1079,1498
242,1498,218,46,158,1076,1498
243,1500,221,41,163,1075,1500
244,1499,218,43,162,1076,1499
245,1500,220,40,165,1075,1500
246,1500,216,46,164,1074,1500
247,1500,216,49,163,1072,1500
248,1499,219,48,160,1072,1499
249,1498,223,45,162,1068,1498
250,1499,221,48,170,1060,1499
251,1499,225,50,171,1053,1499
252,1499,233,53,166,1047,1499
253,1496,237,50,167,1042,1496
254,1500,237,45,181,1037,1500
255,1500,232,50,182,1036,1500
256,1497,242,48,178,1029,1497
257,1500,246,52,178,1024,1500
258,1500,242,53,179,1026,1500
259,1499,243,50,184,1022,1499
260,1500,242,52,189,1017,1500
261,1498,241,56,191,1010,1498
262,1498,246,55,197,1000,1498
263,1500,246,60,195,999,1500
264,1498,253,53,197,995,1498
265,1499,255,52,201,991,1499
266,1500,262,53,204,981,1500
267,1499,258,48,211,982,1499
268,1497,265,49,204,979,1497
269,1498,264,56,204,974,1498
270,1500,259,60,208,973,1500
271,1500,264,60,205,971,1500
272,1499,268,53,211,967,1499
273,1495,261,53,211,970,1495
274,1500,256,62,214,968,1500
275,1500,245,78,210,967,1500
276,1499,241,80,212,966,1499
277,1498,233,80,219,966,1498
278,1500,227,78,224,971,1500
279,1500,207,78,235,980,1500
280,1500,204,79,241,976,1500
281,1499,203,71,244,981,1499
282,1500,193,68,256,983,1500
283,1498,186,64,263,985,1498
284,1495,182,66,263,984,1495
285,1496,181,58,273,984,1496
286,1498,189,52,274,983,1498
287,1500,196,50,273,981,1500
288,1497,186,59,268,984,1497
289,1500,186,59,272,983,1500
290,1499,186,55,271,987,1499
291,1497,181,61,266,989,1497
292,1500,190,55,264,991,1500
293,1500,193,64,249,994,1500
294,1500,198,67,245,990,1500
295,1499,199,70,241,989,1499
296,1496,203,64,237,992,1496
297,1494,203,67,233,991,1494
298,1495,217,59,240,979,1495
299,1495,233,58,236,968,1495
300,1497,239,61,236,961,1497
301,1499,255,65,232,947,1499
302,1498,259,66,237,936,1498
303,1500,258,76,239,927,1500
304,1500,259,76,242,923,1500
305,1499,260,76,248,915,1499
306,1498,262,80,245,911,1498
307,1500,252,85,261,902,1500
308,1500,254,89,263,894,1500
309,1500,262,86,266,886,1500
310,1492,273,77,275,867,1492
311,1494,285,79,283,847,1494
312,1493,274,95,283,841,1493
313,1493,269,103,290,831,1493
314,1493,271,115,287,820,1493
315,1500,257,118,309,816,1500
316,1500,255,113,322,810,1500
317,1499,256,108,334,801,1499
318,1500,236,103,354,807,1500
319,1493,208,114,365,806,1493
320,1497,206,122,368,801,1497
321,1488,189,120,371,808,1488
322,1484,182,106,393,803,1484
323,1484,172,96,408,808,1484
324,1485,164,99,405,817,1485
325,1478,152,94,413,819,1478
326,1477,156,92,410,819,1477
327,1474,147,86,420,821,1474
328,1478,138,82,431,827,1478
329,1471,134,86,419,832,1471
330,1466,124,94,404,844,1466
331,1458,117,90,402,849,1458
332,1458,118,73,395,872,1458
333,1446,111,73,380,882,1446
334,1452,112,64,385,891,1452
335,1446,119,51,375,901,1446
336,1438,126,44,355,913,1438
337,1432,128,43,333,928,1432
338,1430,124,43,322,941,1430
339,1422,121,53,296,952,1422
340,1423,126,47,292,958,1423
341,1421,133,43,271,974,1421
342,1423,147,34,259,983,1423
343,1430,150,37,248,995,1430
344,1431,150,38,243,1000,1431
345,1426,148,46,223,1009,1426
346,1419,154,41,202,1022,1419
347,1418,158,38,199,1023,1418
348,1424,170,34,185,1035,1424
349,1429,174,36,176,1043,1429
350,1441,182,42,166,1051,1441
351,1444,186,44,161,1053,1444
352,1447,189,43,158,1057,1447
353,1458,196,44,159,1059,1458
354,1474,212,34,161,1067,1474
355,1485,218,36,161,1070,1485
356,1494,224,40,157,1073,1494
357,1495,224,44,150,1077,1495
358,1500,228,43,150,1079,1500
359,1499,216,45,160,1078,1499
360,1499,212,52,160,1075,1499
361,1498,214,53,156,1075,1498
362,1499,203,59,156,1081,1499
363,1500,198,50,166,1086,1500
364,1500,198,42,176,1084,1500
365,1499,199,39,177,1084,1499
366,1500,197,41,177,1085,1500
367,1500,197,39,181,1083,1500
368,1500,188,50,175,1087,1500
369,1500,180,57,174,1089,1500
370,1500,174,65,170,1091,1500
371,1500,171,60,182,1087,1500
372,1500,175,44,196,1085,1500
373,1500,171,45,193,1091,1500
374,1500,161,46,197,1096,1500
375,1500,165,46,198,1091,1500
376,1500,163,43,202,1092,1500
377,1499,178,37,193,1091,1499
378,1500,185,34,189,1092,1500
379,1499,185,34,188,1092,1499
380,1500,184,37,185,1094,1500
381,1499,181,47,179,1092,1499
382,1500,175,48,182,1095,1500
383,1500,178,46,182,1094,1500
384,1500,174,46,189,1091,1500
385,1500,168,48,187,1097,1500
386,1496,168,47,173,1108,1496
387,1500,176,42,175,1107,1500
388,1496,181,39,171,1105,1496
389,1500,190,33,174,1103,1500
390,1499,194,33,168,1104,1499
391,1498,193,35,167,1103,1498
392,1500,196,35,162,1107,1500
393,1500,193,40,160,1107,1500
394,1500,194,42,161,1103,1500
395,1500,194,43,165,1098,1500
396,1499,200,34,166,1099,1499
397,1498,202,36,164,1096,1498
398,1500,209,42,161,1088,1500
399,1500,209,45,159,1087,1500
400,1499,212,50,151,1086,1499
401,1499,219,50,150,1080,1499
402,1499,217,42,161,1079,1499
403,1500,221,41,158,1080,1500
404,1500,216,47,156,1081,1500
405,1500,209,50,162,1079,1500
406,1499,205,57,162,1075,1499
407,1499,207,58,163,1071,1499
408,1500,204,55,176,1065,1500
409,1499,206,49,181,1063,1499
410,1496,214,46,181,1055,1496
411,1499,215,47,189,1048,1499
412,1499,218,55,190,1036,1499
413,1498,223,55,190,1030,1498
414,1500,222,62,195,1021,1500
415,1500,216,66,203,1015,1500
416,1498,219,63,201,1015,1498
417,1499,227,63,200,1009,1499
418,1499,219,60,211,1009,1499
419,1495,220,58,216,1001,1495
420,1500,218,61,222,999,1500
421,1499,217,66,225,991,1499
422,1500,223,61,221,995,1500
423,1500,223,59,224,994,1500
424,1498,219,64,225,990,1498
425,1491,209,68,226,988,1491
426,1497,221,69,226,981,1497
427,1499,214,65,235,985,1499
428,1499,203,65,248,983,1499
429,1500,203,65,246,986,1500
430,1499,201,68,237,993,1499
431,1500,192,69,248,991,1500
432,1500,199,60,250,991,1500
433,1495,192,60,247,996,1495
434,1492,183,68,247,994,1492
435,1497,185,68,251,993,1497
436,1500,184,71,248,997,1500
437,1500,187,60,256,997,1500
438,1500,182,71,254,993,1500
439,1500,184,67,255,994,1500
440,1499,172,71,263,993,1499
441,1497,179,71,255,992,1497
442,1496,176,66,254,1000,1496
443,1497,175,69,257,996,1497
444,1500,196,59,265,980,1500
445,1496,201,55,262,978,1496
446,1496,202,59,259,976,1496
447,1497,202,61,258,976,1497
448,1496,206,67,253,970,1496
449,1500,225,61,251,963,1500
450,1500,215,64,263,958,1500
451,1497,212,67,254,964,1497
452,1499,227,77,250,945,1499
453,1499,234,75,250,940,1499
454,1499,237,69,253,940,1499
455,1498,234,70,262,932,1498
456,1499,244,73,261,921,1499
457,1496,242,88,253,913,1496
458,1500,242,97,252,909,1500
459,1496,242,92,262,900,1496
460,1497,238,95,265,899,1497
461,1499,240,91,282,886,1499
462,1499,230,98,294,877,1499
463,1500,218,108,305,869,1500
464,1495,216,97,309,873,1495
465,1490,210,100,317,863,1490
466,1498,208,106,334,850,1498
467,1497,196,101,347,853,1497
468,1494,197,99,350,848,1494
469,1495,189,95,360,851,1495
470,1498,184,97,366,851,1498
471,1499,179,93,376,851,1499
472,1498,159,94,392,853,1498
473,1491,152,93,385,861,1491
474,1491,149,91,389,862,1491
475,1483,143,82,385,873,1483
476,1480,139,78,389,874,1480
477,1470,137,79,382,872,1470
478,1469,132,79,372,886,1469
479,1467,131,68,367,901,1467
480,1474,140,51,370,913,1474
481,1474,133,59,354,928,1474
482,1474,135,63,342,934,1474
483,1473,144,66,322,941,1473
484,1466,141,68,310,947,1466
485,1462,144,52,311,955,1462
486,1463,148,54,293,968,1463
487,1464,146,52,290,976,1464
488,1461,146,59,278,978,1461
489,1453,149,60,259,985,1453
490,1448,150,54,250,994,1448
491,1451,144,56,247,1004,1451
492,1445,138,48,250,1009,1445
493,1440,135,58,239,1008,1440
494,1436,147,56,222,1011,1436
495,1439,152,52,224,1011,1439
496,1446,156,55,222,1013,1446
497,1445,151,57,226,1011,1445
498,1447,156,53,228,1010,1447
499,1450,163,53,215,1019,1450
500,1454,162,49,218,1025,1454
501,1461,172,48,215,1026,1461
502,1462,166,58,213,1025,1462
503,1465,163,66,213,1023,1465
504,1469,165,69,209,1026,1469
505,1468,165,69,215,1019,1468
506,1466,174,63,210,1019,1466
507,1473,177,61,216,1019,1473
508,1480,183,51,228,1018,1480
509,1479,176,57,225,1021,1479
510,1484,170,68,225,1021,1484
511,1493,185,65,220,1023,1493
512,1491,181,67,222,1021,1491
513,1495,180,66,229,1020,1495
514,1490,173,58,234,1025,1490
515,1499,178,55,236,1030,1499
516,1500,179,54,236,1031,1500
517,1500,175,47,247,1031,1500
518,1500,170,45,248,1037,1500
519,1496,175,51,237,1033,1496
520,1499,183,49,232,1035,1499
521,1497,180,49,231,1037,1497
522,1499,181,58,216,1044,1499
523,1498,179,58,217,1044,1498
524,1498,180,53,220,1045,1498
525,1500,178,49,224,1049,1500
526,1499,174,48,223,1054,1499
527,1497,171,46,217,1063,1497
528,1489,172,46,205,1066,1489
529,1493,179,44,204,1066,1493
530,1500,183,48,198,1071,1500
531,1493,176,48,190,1079,1493
532,1498,171,54,192,1081,1498
533,1500,173,54,193,1080,1500
534,1498,168,52,191,1087,1498
535,1500,172,44,195,1089,1500
536,1500,177,39,201,1083,1500
537,1500,183,35,194,1088,1500
538,1500,183,36,190,1091,1500
539,1500,183,34,186,1097,1500
540,1497,177,43,178,1099,1497
541,1498,171,52,171,1104,1498
542,1499,181,50,169,1099,1499
543,1500,183,50,168,1099,1500
544,1500,177,45,181,1097,1500
545,1500,177,44,177,1102,1500
546,1499,178,45,172,1104,1499
547,1500,181,39,176,1104,1500
548,1497,180,39,175,1103,1497
549,1497,188,42,167,1100,1497
550,1499,204,36,165,1094,1499
551,1500,204,38,166,1092,1500
552,1500,205,46,163,1086,1500
553,1498,211,47,161,1079,1498
554,1497,210,45,165,1077,1497
555,1500,215,40,173,1072,1500
556,1499,212,47,174,1066,1499
557,1500,215,47,174,1064,1500
558,1500,225,44,165,1066,1500
559,1498,233,35,169,1061,1498
560,1500,236,35,169,1060,1500
561,1500,241,37,166,1056,1500
562,1500,254,34,164,1048,1500
563,1500,252,39,161,1048,1500
564,1498,241,50,160,1047,1498
565,1500,242,52,161,1045,1500
566,1500,237,61,161,1041,1500
567,1500,232,60,170,1038,1500
568,1500,236,50,177,1037,1500
569,1500,232,55,176,1037,1500
570,1497,227,55,182,1033,1497
571,1497,227,65,180,1025,1497
572,1499,223,70,185,1021,1499
573,1500,223,71,185,1021,1500
574,1500,227,65,195,1013,1500
575,1500,213,69,204,1014,1500
576,1498,211,59,217,1011,1498
577,1500,217,61,221,1001,1500
578,1500,217,56,231,996,1500
579,1498,213,52,239,994,1498
580,1500,206,65,242,987,1500
581,1500,205,66,238,991,1500
582,1500,204,63,236,997,1500
583,1498,202,60,241,995,1498
584,1499,208,57,244,990,1499
585,1500,200,60,247,993,1500
586,1500,190,65,244,1001,1500
587,1500,187,58,249,1006,1500
588,1498,198,51,247,1002,1498
589,1500,203,55,240,1002,1500
590,1498,210,52,234,1002,1498
591,1498,202,56,238,1002,1498
592,1495,208,60,227,1000,1495
593,1491,204,64,225,998,1491
594,1498,210,65,228,995,1498
595,1498,206,77,230,985,1498
596,1494,208,73,233,980,1494
597,1500,216,68,231,985,1500
598,1497,224,68,230,975,1497
599,1495,230,58,243,964,1495
600,1498,241,60,247,950,1498
601,1493,252,64,240,937,1493
602,1498,256,67,241,934,1498
603,1498,259,70,243,926,1498
604,1500,259,72,245,924,1500
605,1499,262,64,250,923,1499
606,1500,269,68,255,908,1500
607,1500,260,74,257,909,1500
608,1500,260,71,265,904,1500
609,1500,256,85,262,897,1500
610,1499,243,101,263,892,1499
611,1498,242,98,272,886,1498
612,1498,241,95,277,885,1498
613,1494,237,87,279,891,1494
614,1495,233,85,289,888,1495
615,1500,229,78,304,889,1500
616,1499,207,91,307,894,1499
617,1500,188,104,310,898,1500
618,1500,181,104,314,901,1500
619,1497,176,101,322,898,1497
620,1500,180,91,337,892,1500
621,1500,168,85,351,896,1500
622,1499,159,88,348,904,1499
623,1500,151,83,359,907,1500
624,1494,147,78,360,909,1494
625,1497,146,73,359,919,1497
626,1499,152,73,355,919,1499
627,1494,143,74,346,931,1494
628,1493,145,71,340,937,1493
629,1490,141,74,331,944,1490
630,1499,137,83,327,952,1499
631,1500,129,80,335,956,1500
632,1500,127,80,329,964,1500
633,1494,130,74,321,969,1494
634,1486,125,62,320,979,1486
635,1491,140,54,306,991,1491
636,1487,146,50,301,990,1487
637,1485,144,53,293,995,1485
638,1480,145,55,286,994,1480
639,1485,152,61,271,1001,1485
640,1480,150,65,263,1002,1480
641,1476,155,49,266,1006,1476
642,1472,166,49,259,998,1472
643,1476,173,42,260,1001,1476
644,1481,171,55,252,1003,1481
645,1476,176,58,236,1006,1476
646,1471,182,54,233,1002,1471
647,1468,194,48,228,998,1468
648,1464,193,49,216,1006,1464
649,1461,191,49,213,1008,1461
650,1468,199,52,208,1009,1468
651,1473,206,56,204,1007,1473
652,1477,208,55,207,1007,1477
653,1482,210,54,211,1007,1482
654,1491,215,61,209,1006,1491
655,1496,222,54,207,1013,1496
656,1499,217,61,207,1014,1499
657,1497,221,63,198,1015,1497
658,1500,224,55,211,1010,1500
659,1500,217,62,215,1006,1500
660,1500,214,57,220,1009,1500
661,1500,221,57,217,1005,1500
662,1498,213,62,215,1008,1498
663,1500,210,59,221,1010,1500
664,1497,205,62,220,1010,1497
665,1500,208,61,224,1007,1500
666,1499,204,62,227,1006,1499
667,1500,203,61,232,1004,1500
668,1497,198,59,236,1004,1497
669,1496,201,63,229,1003,1496
670,1498,202,59,235,1002,1498
671,1500,195,64,238,1003,1500
672,1496,195,59,233,1009,1496
673,1498,194,59,232,1013,1498
674,1496,198,52,228,1018,1496
675,1497,187,53,236,1021,1497
676,1497,182,59,235,1021,1497
677,1499,184,70,222,1023,1499
678,1499,180,74,228,1017,1499
679,1500,179,65,234,1022,1500
680,1495,179,60,229,1027,1495
681,1496,175,54,236,1031,1496
682,1497,167,59,237,1034,1497
683,1500,166,69,235,1030,1500
684,1495,158,69,233,1035,1495
685,1498,167,57,240,1034,1498
686,1500,173,51,238,1038,1500
687,1498,176,41,244,1037,1498
688,1500,176,39,245,1040,1500
689,1499,177,46,232,1044,1499
690,1497,177,45,228,1047,1497
691,1500,175,51,230,1044,1500
692,1496,168,47,233,1048,1496
693,1500,177,51,220,1052,1500
694,1500,173,52,218,1057,1500
695,1497,180,48,208,1061,1497
696,1498,174,51,207,1066,1498
697,1498,165,53,209,1071,1498
698,1500,171,47,206,1076,1500
699,1499,167,50,198,1084,1499
700,1500,167,47,198,1088,1500
701,1499,168,50,191,1090,1499
702,1500,170,52,185,1093,1500
703,1500,167,47,193,1093,1500
704,1498,165,46,195,1092,1498
705,1499,162,44,202,1091,1499
706,1498,173,47,194,1084,1498
707,1500,182,45,195,1078,1500
708,1500,180,45,194,1081,1500
709,1500,188,38,195,1079,1500
710,1498,198,33,193,1074,1498
711,1500,195,43,187,1075,1500
712,1499,197,44,183,1075,1499
713,1500,197,48,181,1074,1500
714,1500,204,47,175,1074,1500
715,1499,206,42,182,1069,1499
716,1499,204,52,176,1067,1499
717,1499,210,47,178,1064,1499
718,1500,211,52,175,1062,1500
719,1497,213,46,174,1064,1497
720,1500,208,51,175,1066,1500
721,1500,206,52,177,1065,1500
722,1500,199,54,183,1064,1500
723,1498,196,55,181,1066,1498
724,1499,194,64,177,1064,1499
725,1499,199,57,188,1055,1499
726,1499,196,55,195,1053,1499
727,1499,198,56,199,1046,1499
728,1499,203,47,204,1045,1499
729,1499,204,46,201,1048,1499
730,1499,201,47,210,1041,1499
731,1496,190,54,206,1046,1496
732,1496,188,61,205,1042,1496
733,1495,198,56,204,1037,1495
734,1500,202,53,209,1036,1500
735,1499,190,61,211,1037,1499
736,1498,198,53,210,1037,1498
737,1500,206,51,205,1038,1500
738,1499,202,47,215,1035,1499
739,1498,207,45,216,1030,1498
740,1499,198,57,208,1036,1499
741,1500,199,66,199,1036,1500
742,1498,207,58,205,1028,1498
743,1498,200,65,202,1031,1498
744,1499,194,64,212,1029,1499
745,1500,201,67,211,1021,1500
746,1500,202,69,216,1013,1500
747,1500,209,60,227,1004,1500
748,1497,208,64,226,999,1497
749,1499,213,69,226,991,1499
750,1499,219,65,229,986,1499
751,1499,219,66,235,979,1499
752,1495,224,62,236,973,1495
753,1491,231,60,233,967,1491
754,1496,236,69,241,950,1496
755,1500,240,78,252,930,1500
756,1498,238,76,249,935,1498
757,1499,230,84,252,933,1499
758,1496,226,77,257,936,1496
759,1496,224,78,266,928,1496
760,1500,219,77,273,931,1500
761,1490,214,78,268,930,1490
762,1495,206,77,281,931,1495
763,1498,211,76,282,929,1498
764,1498,215,65,285,933,1498
765,1498,203,72,291,932,1498
766,1498,201,67,293,937,1498
767,1499,195,75,290,939,1499
768,1497,198,80,288,931,1497
769,1494,186,79,299,930,1494
770,1498,188,79,298,933,1498
771,1498,185,83,299,931,1498
772,1493,175,80,298,940,1493
773,1500,181,71,299,949,1500
774,1499,178,68,299,954,1499
775,1497,179,68,301,949,1497
776,1492,177,68,290,957,1492
777,1496,176,73,291,956,1496
778,1491,177,68,283,963,1491
779,1495,177,64,284,970,1495
780,1498,182,62,282,972,1498
781,1500,173,64,287,976,1500
782,1498,161,79,285,973,1498
783,1499,156,87,275,981,1499
784,1498,152,81,278,987,1498
785,1496,145,74,289,988,1496
786,1494,156,61,284,993,1494
787,1497,158,55,283,1001,1497
788,1495,159,48,280,1008,1495
789,1492,152,57,271,1012,1492
790,1496,152,64,265,1015,1496
791,1499,150,65,264,1020,1499
792,1498,144,72,266,1016,1498
793,1494,151,65,262,1016,1494
794,1499,154,63,260,1022,1499
795,1498,153,55,261,1029,1498
796,1499,150,52,268,1029,1499
797,1498,158,49,264,1027,1498
798,1497,153,55,254,1035,1497
799,1491,155,56,242,1038,1491
800,1500,160,62,234,1044,1500
801,1498,164,63,225,1046,1498
802,1496,168,57,226,1045,1496
803,1496,165,55,230,1046,1496
804,1499,169,57,232,1041,1499
805,1498,168,53,232,1045,1498
806,1496,165,60,227,1044,1496
807,1497,161,55,230,1051,1497
808,1500,170,56,222,1052,1500
809,1498,171,57,218,1052,1498
810,1497,178,47,219,1053,1497
811,1496,175,50,216,1055,1496
812,1498,182,42,222,1052,1498
813,1500,189,45,217,1049,1500
814,1499,194,44,216,1045,1499
815,1500,201,45,215,1039,1500
816,1495,205,48,203,1039,1495
817,1494,207,47,201,1039,1494
818,1499,219,40,204,1036,1499
819,1500,223,46,198,1033,1500
820,1499,221,45,201,1032,1499
821,1500,231,51,188,1030,1500
822,1499,226,62,189,1022,1499
823,1499,221,63,189,1026,1499
824,1500,223,62,181,1034,1500
825,1499,218,61,187,1033,1499
826,1497,217,50,193,1037,1497
827,1500,212,58,195,1035,1500
828,1500,212,57,195,1036,1500
829,1499,209,61,199,1030,1499
830,1500,200,65,210,1025,1500
831,1494,187,76,208,1023,1494
832,1499,198,70,208,1023,1499
833,1499,198,63,218,1020,1499
834,1499,199,58,226,1016,1499
835,1499,196,50,239,1014,1499
836,1497,186,57,240,1014,1497
837,1499,181,62,238,1018,1499
838,1500,183,54,241,1022,1500
839,1499,188,52,237,1022,1499
840,1497,180,50,236,1031,1497
841,1500,180,53,234,1033,1500
842,1498,172,66,232,1028,1498
843,1500,182,60,230,1028,1500
844,1497,178,59,230,1030,1497
845,1498,169,57,234,1038,1498
846,1496,164,55,235,1042,1496
847,1494,167,57,226,1044,1494
848,1490,168,51,222,1049,1490
849,1491,180,49,214,1048,1491
850,1496,174,54,218,1050,1496
851,1498,183,55,215,1045,1498
852,1500,179,63,212,1046,1500
853,1500,188,63,211,1038,1500
854,1496,191,51,212,1042,1496
855,1497,188,52,217,1040,1497
856,1500,182,53,226,1039,1500
857,1500,186,57,221,1036,1500
858,1499,187,53,218,1041,1499
859,1497,192,50,215,1040,1497
860,1500,199,46,216,1039,1500
861,1499,192,53,218,1036,1499
862,1500,185,61,210,1044,1500
863,1497,188,59,211,1039,1497
864,1499,187,64,208,1040,1499
865,1500,186,59,217,1038,1500
866,1500,186,52,222,1040,1500
867,1498,186,51,227,1034,1498
868,1497,184,55,218,1040,1497
869,1496,188,54,216,1038,1496
870,1499,202,50,209,1038,1499
871,1497,199,43,219,1036,1497
872,1500,196,48,216,1040,1500
873,1497,193,48,214,1042,1497
874,1500,189,54,204,1053,1500
875,1499,188,44,210,1057,1499
876,1500,191,47,211,1051,1500
877,1500,185,48,214,1053,1500
878,1499,185,55,211,1048,1499
879,1499,182,66,196,1055,1499
880,1496,195,53,201,1047,1496
881,1500,205,52,200,1043,1500
882,1497,198,55,203,1041,1497
883,1500,198,59,202,1041,1500
884,1500,200,64,197,1039,1500
885,1500,206,55,200,1039,1500
886,1498,200,58,207,1033,1498
887,1499,203,58,209,1029,1499
888,1500,193,68,215,1024,1500
889,1494,184,73,209,1028,1494
890,1500,199,64,216,1021,1500
891,1498,199,62,216,1021,1498
892,1500,208,49,231,1012,1500
893,1500,210,49,241,1000,1500
894,1490,207,56,232,995,1490
895,1496,217,55,229,995,1496
896,1499,231,53,225,990,1499
897,1500,220,60,229,991,1500
898,1500,215,62,241,982,1500
899,1494,214,73,226,981,1494
900,1492,219,68,229,976,1492
901,1500,230,60,234,976,1500
902,1500,224,57,240,979,1500
903,1499,230,60,243,966,1499
904,1499,231,61,240,967,1499
905,1500,222,74,237,967,1500
906,1497,225,78,227,967,1497
907,1498,222,80,233,963,1498
908,1500,229,70,240,961,1500
909,1499,218,69,252,960,1499
910,1497,212,74,257,954,1497
911,1496,213,75,260,948,1496
912,1499,208,78,260,953,1499
913,1498,198,78,274,948,1498
914,1491,199,76,272,944,1491
915,1486,201,66,277,942,1486
916,1493,206,56,282,949,1493
917,1498,212,58,278,950,1498
918,1499,207,65,279,948,1499
919,1500,216,63,279,942,1500
920,1499,215,66,284,934,1499
921,1495,214,70,277,934,1495
922,1498,211,78,275,934,1498
923,1498,199,83,269,947,1498
924,1498,193,85,270,950,1498
925,1499,192,82,274,951,1499
926,1495,188,78,279,950,1495
927,1498,204,67,280,947,1498
928,1496,199,68,282,947,1496
929,1498,201,66,280,951,1498
930,1496,202,72,272,950,1496
931,1497,193,82,275,947,1497
932,1497,187,73,282,955,1497
933,1499,189,80,281,949,1499
934,1495,188,65,292,950,1495
935,1497,181,66,299,951,1497
936,1495,178,72,296,949,1495
937,1499,172,77,293,957,1499
938,1497,163,78,295,961,1497
939,1497,169,76,289,963,1497
940,1491,166,70,287,968,1491
941,1487,169,62,289,967,1487
942,1488,168,58,288,974,1488
943,1481,168,60,281,972,1481
944,1491,182,62,281,966,1491
945,1496,177,65,282,972,1496
946,1500,168,77,274,981,1500
947,1498,158,80,277,983,1498
948,1488,161,75,267,985,1488
949,1487,156,75,262,994,1487
950,1492,160,52,280,1000,1492
951,1499,165,54,279,1001,1499
952,1491,152,65,272,1002,1491
953,1496,149,71,269,1007,1496
954,1500,147,74,258,1021,1500
955,1498,145,65,256,1032,1498
956,1500,141,66,255,1038,1500
957,1500,147,59,260,1034,1500
958,1498,155,56,257,1030,1498
959,1500,162,48,258,1032,1500
960,1499,163,51,260,1025,1499
961,1497,153,61,256,1027,1497
962,1499,151,69,246,1033,1499
963,1499,157,74,239,1029,1499
964,1492,161,59,234,1038,1492
965,1495,167,55,239,1034,1495
966,1500,173,49,245,1033,1500
967,1499,164,58,240,1037,1499
968,1500,168,59,241,1032,1500
969,1499,165,58,240,1036,1499
970,1500,167,55,232,1046,1500
971,1500,159,56,230,1055,1500
972,1499,156,60,225,1058,1499
973,1500,157,52,227,1064,1500
974,1497,158,48,228,1063,1497
975,1499,162,42,231,1064,1499
976,1498,160,53,227,1058,1498
977,1500,156,53,236,1055,1500
978,1497,165,53,219,1060,1497
979,1493,172,49,211,1061,1493
980,1499,190,39,210,1060,1499
981,1499,182,42,215,1060,1499
982,1499,179,55,210,1055,1499
983,1497,179,56,199,1063,1497
984,1500,189,47,203,1061,1500
985,1499,185,41,202,1071,1499
986,1500,182,42,206,1070,1500
987,1494,184,39,197,1074,1494
988,1497,197,44,185,1071,1497
989,1500,200,45,181,1074,1500
990,1500,204,42,188,1066,1500
991,1499,204,46,177,1072,1499
992,1500,213,39,182,1066,1500
993,1499,215,40,181,1063,1499
994,1499,221,44,175,1059,1499
995,1498,222,49,168,1059,1498
996,1500,223,50,169,1058,1500
997,1497,225,46,176,1050,1497
998,1499,225,47,174,1053,1499
999,1498,233,43,169,1053,1498
1000,1499,232,40,169,1058,1499
1001,1500,228,49,167,1056,1500
1002,1500,232,43,174,1051,1500
1003,1500,232,49,172,1047,1500
1004,1500,238,47,171,1044,1500
1005,1500,240,43,179,1038,1500
1006,1496,231,51,170,1044,1496
1007,1499,228,49,175,1047,1499
1008,1500,221,54,173,1052,1500
1009,1499,218,56,178,1047,1499
1010,1497,214,50,189,1044,1497
1011,1500,218,53,184,1045,1500
1012,1499,221,49,185,1044,1499
1013,1499,211,56,184,1048,1499
1014,1499,207,54,188,1050,1499
1015,1500,209,53,193,1045,1500
1016,1496,209,51,194,1042,1496
1017,1500,213,51,199,1037,1500
1018,1500,207,54,199,1040,1500
1019,1499,218,51,197,1033,1499
1020,1500,209,54,204,1033,1500
1021,1500,212,50,203,1035,1500
1022,1500,202,56,207,1035,1500
1023,1500,195,61,211,1033,1500
1024,1499,190,71,201,1037,1499
1025,1499,185,78,202,1034,1499
1026,1499,188,70,213,1028,1499
1027,1500,188,66,220,1026,1500
1028,1500,186,64,222,1028,1500
1029,1499,190,50,234,1025,1499
1030,1500,186,53,232,1029,1500
1031,1499,186,54,231,1028,1499
1032,1500,189,55,234,1022,1500
1033,1499,179,62,230,1028,1499
1034,1499,188,50,233,1028,1499
1035,1499,178,58,233,1030,1499
1036,1499,189,45,242,1023,1499
1037,1499,193,53,232,1021,1499
1038,1498,189,64,231,1014,1498
1039,1499,194,54,241,1010,1499
1040,1496,199,58,225,1014,1496
1041,1499,204,64,221,1010,1499
1042,1500,203,62,220,1015,1500
1043,1499,213,60,210,1016,1499
1044,1500,217,54,214,1015,1500
1045,1497,216,51,218,1012,1497
1046,1499,215,52,217,1015,1499
1047,1500,218,51,222,1009,1500
1048,1499,218,56,214,1011,1499
1049,1500,228,50,218,1004,1500
1050,1500,233,51,207,1009,1500
1051,1498,212,64,213,1009,1498
1052,1499,208,69,217,1005,1499
1053,1497,204,70,210,1013,1497
1054,1499,208,61,221,1009,1499
1055,1499,210,54,226,1009,1499
1056,1500,202,54,227,1017,1500
1057,1496,208,51,229,1008,1496
1058,1495,209,61,220,1005,1495
1059,1495,215,63,217,1000,1495
1060,1499,223,64,218,994,1499
1061,1499,223,61,223,992,1499
1062,1500,225,57,231,987,1500
1063,1500,227,55,231,987,1500
1064,1499,217,64,233,985,1499
1065,1497,221,62,234,980,1497
1066,1498,225,68,237,968,1498
1067,1498,230,62,239,967,1498
1068,1496,234,56,241,965,1496
1069,1494,246,56,232,960,1494
1070,1495,245,54,233,963,1495
1071,1495,245,59,228,963,1495
1072,1500,234,69,237,960,1500
1073,1498,233,75,235,955,1498
1074,1500,239,80,236,945,1500
1075,1495,233,84,238,940,1495
1076,1497,235,82,244,936,1497
1077,1497,222,90,244,941,1497
1078,1500,214,88,253,945,1500
1079,1499,207,84,263,945,1499
1080,1500,198,77,274,951,1500
1081,1496,181,87,277,951,1496
1082,1490,177,88,275,950,1490
1083,1493,173,81,289,950,1493
1084,1500,189,79,288,944,1500
1085,1500,182,65,310,943,1500
1086,1496,170,69,310,947,1496
1087,1499,175,67,314,943,1499
1088,1500,165,75,314,946,1500
1089,1497,169,67,317,944,1497
1090,1499,183,64,308,944,1499
1091,1499,186,65,307,941,1499
1092,1499,178,70,308,943,1499
1093,1491,173,75,295,948,1491
1094,1492,178,75,284,955,1492
1095,1492,173,70,289,960,1492
1096,1498,171,64,294,969,1498
1097,1497,166,69,282,980,1497
1098,1496,171,69,281,975,1496
1099,1495,173,65,268,989,1495
1100,1499,177,64,270,988,1499
1101,1500,174,65,272,989,1500
1102,1500,167,69,269,995,1500
1103,1498,176,63,264,995,1498
1104,1500,179,58,271,992,1500
1105,1497,186,55,271,985,1497
1106,1496,187,55,260,994,1496
1107,1500,188,57,263,992,1500
1108,1497,185,54,269,989,1497
1109,1493,180,62,255,996,1493
1110,1499,184,70,238,1007,1499
1111,1499,178,69,244,1008,1499
1112,1498,174,66,248,1010,1498
1113,1494,174,62,244,1014,1494
1114,1499,180,55,246,1018,1499
1115,1496,173,58,244,1021,1496
1116,1498,171,57,246,1024,1498
1117,1500,174,54,239,1033,1500
1118,1496,176,56,232,1032,1496
1119,1492,179,51,235,1027,1492
1120,1500,195,51,230,1024,1500
1121,1495,181,58,230,1026,1495
1122,1497,179,54,226,1038,1497
1123,1499,175,56,228,1040,1499
1124,1500,176,52,234,1038,1500
1125,1499,170,48,232,1049,1499
1126,1498,171,55,224,1048,1498
1127,1496,168,62,218,1048,1496
1128,1500,172,62,212,1054,1500
1129,1498,164,63,211,1060,1498
1130,1494,153,60,217,1064,1494
1131,1495,151,66,218,1060,1495
1132,1498,155,63,219,1061,1498
1133,1500,161,62,215,1062,1500
1134,1500,160,54,230,1056,1500
1135,1500,158,51,232,1059,1500
1136,1498,156,53,224,1065,1498
1137,1500,150,53,227,1070,1500
1138,1498,150,49,229,1070,1498
1139,1500,155,43,225,1077,1500
1140,1498,160,40,222,1076,1498
1141,1500,161,38,229,1072,1500
1142,1499,161,41,223,1074,1499
1143,1500,154,50,215,1081,1500
1144,1493,165,52,203,1073,1493
1145,1495,169,50,202,1074,1495
1146,1497,171,50,202,1074,1497
1147,1499,176,47,201,1075,1499
1148,1498,181,49,192,1076,1498
1149,1500,180,51,189,1080,1500
1150,1500,173,59,191,1077,1500
1151,1500,162,70,187,1081,1500
1152,1500,156,71,187,1086,1500
1153,1499,163,62,189,1085,1499
1154,1499,166,54,199,1080,1499
1155,1495,176,40,204,1075,1495
1156,1498,172,42,208,1076,1498
1157,1499,174,47,206,1072,1499
1158,1500,169,46,210,1075,1500
1159,1499,169,47,209,1074,1499
1160,1497,168,50,207,1072,1497
1161,1500,169,53,205,1073,1500
1162,1499,176,53,203,1067,1499
1163,1499,188,56,199,1056,1499
1164,1499,191,50,204,1054,1499
1165,1496,187,49,208,1052,1496
1166,1493,198,45,204,1046,1493
1167,1500,206,42,202,1050,1500
1168,1500,208,51,189,1052,1500
1169,1499,207,52,186,1054,1499
1170,1500,219,51,182,1048,1500
1171,1500,209,56,187,1048,1500
1172,1500,205,53,192,1050,1500
1173,1498,208,52,194,1044,1498
1174,1500,209,53,193,1045,1500
1175,1500,210,49,195,1046,1500
1176,1500,212,56,195,1037,1500
1177,1497,210,51,203,1033,1497
1178,1498,212,57,197,1032,1498
1179,1499,207,61,194,1037,1499
1180,1500,202,54,202,1042,1500
1181,1499,211,47,202,1039,1499
1182,1499,206,49,207,1037,1499
1183,1499,209,43,207,1040,1499
1184,1499,197,57,208,1037,1499
1185,1499,196,60,206,1037,1499
1186,1495,199,59,200,1037,1495
1187,1500,195,60,207,1038,1500
1188,1500,191,61,213,1035,1500
1189,1500,189,66,210,1035,1500
1190,1500,198,54,217,1031,1500
1191,1497,201,49,218,1029,1497
1192,1498,194,54,221,1029,1498
1193,1500,196,49,224,1031,1500
1194,1499,197,54,215,1033,1499
1195,1500,194,57,218,1031,1500
1196,1499,188,58,220,1033,1499
1197,1495,192,63,212,1028,1495
1198,1497,199,56,220,1022,1497
1199,1500,192,59,231,1018,1500
1200,1496,197,58,231,1010,1496
1201,1495,204,61,224,1006,1495
1202,1493,209,53,226,1005,1493
1203,1500,211,58,227,1004,1500
1204,1500,215,58,224,1003,1500
1205,1498,214,61,220,1003,1498
1206,1498,219,58,221,1000,1498
1207,1498,227,50,221,1000,1498
1208,1500,223,50,231,996,1500
1209,1499,229,51,224,995,1499
1210,1500,237,50,222,991,1500
1211,1500,233,61,220,986,1500
1212,1498,231,63,222,982,1498
1213,1500,233,74,211,982,1500
1214,1500,233,77,220,970,1500
1215,1499,231,79,222,967,1499
1216,1495,233,71,225,966,1495
1217,1499,243,66,234,956,1499
1218,1500,239,66,238,957,1500
1219,1499,247,67,241,944,1499
1220,1499,240,77,240,942,1499
1221,1496,228,79,248,941,1496
1222,1496,233,83,242,938,1496
1223,1498,235,77,256,930,1498
1224,1500,221,84,264,931,1500
1225,1500,214,75,281,930,1500
1226,1496,219,74,276,927,1496
1227,1500,206,75,291,928,1500
1228,1496,201,68,296,931,1496
1229,1499,209,76,289,925,1499
1230,1497,214,74,286,923,1497
1231,1493,209,72,288,924,1493
1232,1493,209,70,287,927,1493
1233,1499,194,88,287,930,1499
1234,1497,194,84,297,922,1497
1235,1500,198,89,287,926,1500
1236,1495,183,82,301,929,1495
1237,1491,181,80,302,928,1491
1238,1497,185,75,307,930,1497
1239,1498,194,70,299,935,1498
1240,1499,181,72,308,938,1499
1241,1498,177,77,302,942,1498
1242,1489,179,79,294,937,1489
1243,1494,176,78,306,934,1494
1244,1498,178,70,309,941,1498
1245,1494,182,65,309,938,1494
1246,1498,186,64,306,942,1498
1247,1498,174,73,304,947,1498
1248,1491,173,72,303,943,1491
1249,1498,174,75,308,941,1498
1250,1488,173,74,295,946,1488
1251,1492,181,68,289,954,1492
1252,1491,188,58,287,958,1491
1253,1488,184,57,289,958,1488
1254,1489,182,62,278,967,1489
1255,1491,192,56,277,966,1491
1256,1492,195,69,267,961,1492
1257,1495,198,66,270,961,1495
1258,1500,199,68,263,970,1500
1259,1500,194,80,252,974,1500
1260,1500,190,72,263,975,1500
1261,1500,186,73,262,979,1500
1262,1500,184,78,256,982,1500
1263,1496,183,65,267,981,1496
1264,1500,181,68,265,986,1500
1265,1498,178,68,265,987,1498
1266,1496,173,68,260,995,1496
1267,1496,177,64,259,996,1496
1268,1499,180,66,264,989,1499
1269,1498,178,63,271,986,1498
1270,1500,171,68,275,986,1500
1271,1493,166,72,267,988,1493
1272,1494,170,69,273,982,1494
1273,1496,166,68,277,985,1496
1274,1497,173,60,267,997,1497
1275,1500,170,58,272,1000,1500
1276,1500,167,58,275,1000,1500
1277,1493,166,58,256,1013,1493
1278,1499,168,57,258,1016,1499
1279,1495,161,64,249,1021,1495
1280,1499,166,54,255,1024,1499
1281,1499,170,54,251,1024,1499
1282,1500,173,53,246,1028,1500
1283,1497,169,61,235,1032,1497
1284,1499,164,63,241,1031,1499
1285,1500,169,61,238,1032,1500
1286,1496,169,61,230,1036,1496
1287,1496,171,53,235,1037,1496
1288,1499,178,51,235,1035,1499
1289,1499,184,58,224,1033,1499
1290,1497,179,58,223,1037,1497
1291,1500,171,66,222,1041,1500
1292,1500,168,65,225,1042,1500
1293,1500,164,63,231,1042,1500
1294,1499,164,64,223,1048,1499
1295,1499,166,56,230,1047,1499
1296,1499,165,54,230,1050,1499
1297,1496,153,51,237,1055,1496
1298,1500,163,45,233,1059,1500
1299,1500,160,47,236,1057,1500
1300,1493,161,46,233,1053,1493
1301,1497,171,44,220,1062,1497
1302,1497,169,49,215,1064,1497
1303,1500,173,49,223,1055,1500
1304,1497,161,58,214,1064,1497
1305,1500,170,51,216,1063,1500
1306,1500,164,56,209,1071,1500
1307,1499,161,47,217,1074,1499
1308,1500,161,53,208,1078,1500
1309,1500,169,49,201,1081,1500
1310,1499,169,52,200,1078,1499
1311,1498,174,44,199,1081,1498
1312,1499,172,43,196,1088,1499
1313,1496,172,48,188,1088,1496
1314,1500,184,37,194,1085,1500
1315,1500,178,47,191,1084,1500
1316,1499,185,36,197,1081,1499
1317,1500,189,40,187,1084,1500
1318,1500,192,35,188,1085,1500
1319,1498,188,34,189,1087,1498
1320,1499,185,47,182,1085,1499
1321,1498,193,44,169,1092,1498
1322,1500,195,47,170,1088,1500
1323,1500,197,41,170,1092,1500
1324,1498,198,41,169,1090,1498
1325,1500,205,37,164,1094,1500
1326,1500,206,40,161,1093,1500
1327,1500,202,46,162,1090,1500
1328,1499,207,41,157,1094,1499
1329,1500,207,45,163,1085,1500
1330,1497,212,45,154,1086,1497
1331,1500,208,48,160,1084,1500
1332,1498,204,50,162,1082,1498
1333,1500,215,47,161,1077,1500
1334,1500,206,48,170,1076,1500
1335,1500,210,45,170,1075,1500
1336,1499,213,44,176,1066,1499
1337,1498,216,44,173,1065,1498
1338,1500,221,49,172,1058,1500
1339,1498,223,45,175,1055,1498
1340,1499,229,44,175,1051,1499
1341,1500,232,42,180,1046,1500
1342,1500,233,45,180,1042,1500
1343,1500,230,47,178,1045,1500
1344,1496,224,49,180,1043,1496
1345,1500,225,46,184,1045,1500
1346,1499,223,56,181,1039,1499
1347,1499,222,55,182,1040,1499
1348,1499,225,53,181,1040,1499
1349,1499,225,47,191,1036,1499
1350,1497,234,43,189,1031,1497
1351,1500,236,45,189,1030,1500
1352,1498,235,47,194,1022,1498
1353,1500,236,56,186,1022,1500
1354,1500,226,62,188,1024,1500
1355,1499,238,53,191,1017,1499
1356,1500,244,43,196,1017,1500
1357,1499,242,44,201,1012,1499
1358,1496,243,49,201,1003,1496
1359,1494,248,53,196,997,1494
1360,1498,252,53,197,996,1498
1361,1498,246,61,197,994,1498
1362,1500,258,50,200,992,1500
1363,1498,250,53,194,1001,1498
1364,1500,246,59,198,997,1500
1365,1498,252,56,198,992,1498
1366,1498,257,62,193,986,1498
1367,1500,261,56,208,975,1500
1368,1497,254,60,214,969,1497
1369,1493,250,62,212,969,1493
1370,1497,266,55,211,965,1497
1371,1498,271,58,210,959,1498
1372,1500,267,58,219,956,1500
1373,1500,260,65,219,956,1500
1374,1500,254,75,223,948,1500
1375,1500,251,71,226,952,1500
1376,1499,245,74,229,951,1499
1377,1499,238,80,236,945,1499
1378,1497,237,85,238,937,1497
1379,1497,247,74,248,928,1497
1380,1500,240,79,255,926,1500
1381,1495,242,65,264,924,1495
1382,1499,242,73,261,923,1499
1383,1500,238,75,266,921,1500
1384,1500,233,81,268,918,1500
1385,1498,223,82,276,917,1498
1386,1500,230,77,279,914,1500
1387,1500,225,74,291,910,1500
1388,1492,204,81,299,908,1492
1389,1498,206,79,305,908,1498
1390,1493,203,74,303,913,1493
1391,1499,201,76,304,918,1499
1392,1500,194,70,312,924,1500
1393,1500,194,78,302,926,1500
1394,1493,200,77,303,913,1493
1395,1486,196,72,296,922,1486
1396,1491,202,63,303,923,1491
1397,1489,207,66,302,914,1489
1398,1499,211,70,302,916,1499
1399,1498,208,73,297,920,1498
1400,1498,208,85,288,917,1498
1401,1499,212,77,290,920,1499
1402,1496,205,83,285,923,1496
1403,1492,206,79,287,920,1492
1404,1494,197,77,292,928,1494
1405,1493,196,75,291,931,1493
1406,1491,185,83,284,939,1491
1407,1492,178,81,297,936,1492
1408,1493,187,73,299,934,1493
1409,1500,195,74,292,939,1500
1410,1496,192,69,298,937,1496
1411,1499,189,71,302,937,1499
1412,1500,183,86,291,940,1500
1413,1495,167,86,302,940,1495
1414,1499,167,91,305,936,1499
1415,1499,165,89,304,941,1499
1416,1496,157,88,310,941,1496
1417,1493,148,80,318,947,1493
1418,1498,144,93,311,950,1498
1419,1494,138,88,317,951,1494
1420,1500,139,84,320,957,1500
1421,1498,144,78,316,960,1498
1422,1499,148,62,326,963,1499
1423,1500,143,58,325,974,1500
1424,1491,147,52,317,975,1491
1425,1494,144,59,307,984,1494
1426,1500,147,58,319,976,1500
1427,1497,145,67,301,984,1497
1428,1499,147,65,302,985,1499
1429,1496,149,68,294,985,1496
1430,1499,152,63,292,992,1499
1431,1490,149,65,276,1000,1490
1432,1500,159,64,278,999,1500
1433,1490,160,57,270,1003,1490
1434,1490,160,60,264,1006,1490
1435,1490,167,56,258,1009,1490
1436,1490,167,60,240,1023,1490
1437,1490,174,58,240,1018,1490
1438,1497,185,54,238,1020,1497
1439,1500,184,57,238,1021,1500
