ticks,turtles,healthy turtles,exposed turtles,infected turtles,immune turtles,masked turtles
0,1500,1490,10,0,0,1500
1,1500,1490,10,0,0,1500
2,1500,1490,10,0,0,1500
3,1500,1476,14,10,0,1500
4,1500,1470,20,10,0,1500
5,1500,1460,30,10,0,1500
6,1500,1452,36,12,0,1500
7,1500,1430,45,25,0,1500
8,1500,1394,74,32,0,1500
9,1500,1358,100,42,0,1500
10,1500,1315,128,57,0,1500
11,1500,1263,157,80,0,1500
12,1500,1192,190,118,0,1500
13,1500,1111,232,157,0,1500
14,1500,1014,277,209,0,1500
15,1500,928,311,261,0,1500
16,1500,851,308,341,0,1500
17,1499,768,305,419,7,1499
18,1500,680,302,511,7,1500
19,1500,612,282,599,7,1500
20,1500,544,276,672,8,1500
21,1497,485,250,747,15,1497
22,1496,441,218,820,17,1496
23,1498,391,206,879,22,1498
24,1496,353,186,927,30,1496
25,1489,303,190,957,39,1489
26,1472,250,192,975,55,1472
27,1460,213,182,990,75,1460
28,1443,180,174,984,105,1443
29,1415,149,153,987,126,1415
30,1385,121,138,957,169,1385
31,1353,95,125,913,220,1353
32,1310,74,111,858,267,1310
33,1275,56,97,804,318,1275
34,1237,42,87,758,350,1237
35,1194,40,59,705,390,1194
36,1162,38,49,644,431,1162
37,1130,32,37,596,465,1130
38,1097,26,31,549,491,1097
39,1072,24,29,502,517,1072
40,1049,20,29,455,545,1049
41,1033,19,25,411,578,1033
42,1013,21,20,373,599,1013
43,997,23,22,321,631,997
44,973,23,17,280,653,973
45,956,21,16,242,677,956
46,946,24,13,209,700,946
47,936,30,15,178,713,936
48,928,36,11,155,726,928
49,917,38,13,124,742,917
50,913,46,13,105,749,913
51,914,54,10,89,761,914
52,910,52,13,76,769,910
53,919,62,9,75,773,919
54,926,70,11,67,778,926
55,927,76,11,58,782,927
56,928,82,4,57,785,928
57,935,88,5,56,786,935
58,937,92,8,48,789,937
59,941,99,9,43,790,941
60,948,106,9,41,792,948
61,953,110,9,40,794,953
62,959,119,7,38,795,959
63,968,126,6,37,799,968
64,977,134,5,39,799,977
65,983,141,7,34,801,983
66,986,144,7,33,802,986
67,993,150,8,30,805,993
68,1002,155,10,31,806,1002
69,1013,161,14,31,807,1013
70,1019,169,13,28,809,1019
71,1028,173,13,31,811,1028
72,1035,177,17,30,811,1035
73,1044,184,13,35,812,1044
74,1053,189,14,37,813,1053
75,1059,193,12,40,814,1059
76,1072,204,13,39,816,1072
77,1083,214,11,40,818,1083
78,1096,224,12,41,819,1096
79,1103,225,13,46,819,1103
80,1115,233,16,46,820,1115
81,1119,230,19,49,821,1119
82,1132,240,21,49,822,1132
83,1141,236,28,55,822,1141
84,1149,234,32,57,826,1149
85,1160,242,33,57,828,1160
86,1172,246,33,65,828,1172
87,1182,247,31,72,832,1182
88,1188,249,27,77,835,1188
89,1199,252,30,80,837,1199
90,1214,261,32,84,837,1214
91,1225,264,32,90,839,1225
92,1235,264,37,94,840,1235
93,1241,264,38,98,841,1241
94,1252,264,37,108,843,1252
95,1262,263,38,114,847,1262
96,1274,261,44,121,848,1274
97,1290,258,57,123,852,1290
98,1291,251,58,129,853,1291
99,1299,242,65,138,854,1299
100,1306,237,64,149,856,1306
101,1311,228,68,151,864,1311
102,1313,211,74,162,866,1313
103,1321,210,73,168,870,1321
104,1329,198,75,183,873,1329
105,1327,181,75,193,878,1327
106,1330,175,65,207,883,1330
107,1336,162,71,216,887,1336
108,1343,160,60,227,896,1343
109,1344,158,55,232,899,1344
110,1353,154,60,237,902,1353
111,1359,150,54,249,906,1359
112,1360,147,56,246,911,1360
113,1366,146,52,249,919,1366
114,1363,137,51,248,927,1363
115,1362,129,53,249,931,1362
116,1359,126,56,239,938,1359
117,1361,116,60,241,944,1361
118,1360,115,58,231,956,1360
119,1361,109,53,230,969,1361
120,1357,100,55,224,978,1357
121,1361,105,47,224,985,1361
122,1375,126,38,212,999,1375
123,1377,121,39,210,1007,1377
124,1385,125,34,211,1015,1385
125,1386,122,41,198,1025,1386
126,1391,124,43,195,1029,1391
127,1391,119,44,191,1037,1391
128,1387,114,48,184,1041,1387
129,1394,110,51,180,1053,1394
130,1405,112,48,184,1061,1405
131,1412,109,47,182,1074,1412
132,1417,108,47,182,1080,1417
133,1417,108,44,179,1086,1417
134,1425,109,49,173,1094,1425
135,1433,108,51,171,1103,1433
136,1439,107,53,171,1108,1439
137,1442,113,50,171,1108,1442
138,1439,110,46,171,1112,1439
139,1447,107,45,178,1117,1447
140,1455,109,45,184,1117,1455
141,1462,114,47,182,1119,1462
142,1473,119,42,186,1126,1473
143,1475,115,49,186,1125,1475
144,1480,118,56,183,1123,1480
145,1489,122,64,180,1123,1489
146,1499,132,68,184,1115,1499
147,1497,137,74,185,1101,1497
148,1499,150,74,196,1079,1499
149,1499,158,81,196,1064,1499
150,1499,181,78,211,1029,1499
151,1500,211,85,217,987,1500
152,1497,227,97,224,949,1497
153,1499,253,111,230,905,1499
154,1500,267,114,240,879,1500
155,1500,274,119,263,844,1500
156,1499,273,136,278,812,1499
157,1499,258,157,300,784,1499
158,1499,255,163,317,764,1499
159,1500,242,167,347,744,1500
160,1494,221,169,382,722,1494
161,1497,208,172,418,699,1497
162,1496,182,191,432,691,1496
163,1497,173,196,461,667,1497
164,1500,157,192,491,660,1500
165,1492,131,193,523,645,1492
166,1490,120,187,552,631,1490
167,1484,98,178,586,622,1484
168,1487,89,160,615,623,1487
169,1476,74,141,636,625,1476
170,1478,61,126,655,636,1478
171,1468,58,114,657,639,1468
172,1466,56,102,661,647,1466
173,1454,50,86,655,663,1454
174,1446,39,84,633,690,1446
175,1431,37,79,602,713,1431
176,1418,30,73,588,727,1418
177,1403,27,59,570,747,1403
178,1386,29,47,534,776,1386
179,1371,28,39,498,806,1371
180,1353,30,30,464,829,1353
181,1332,32,30,417,853,1332
182,1319,31,32,374,882,1319
183,1292,35,26,328,903,1292
184,1270,32,26,286,926,1270
185,1262,35,24,261,942,1262
186,1256,41,21,236,958,1256
187,1248,50,24,205,969,1248
188,1242,54,25,182,981,1242
189,1241,55,26,168,992,1241
190,1239,60,24,154,1001,1239
191,1231,60,27,132,1012,1231
192,1225,61,24,121,1019,1225
193,1230,71,22,111,1026,1230
194,1233,78,18,102,1035,1233
195,1238,83,17,101,1037,1238
196,1245,90,18,98,1039,1245
197,1254,99,18,93,1044,1254
198,1262,106,23,89,1044,1262
199,1262,111,18,85,1048,1262
200,1272,122,18,83,1049,1272
201,1286,134,19,84,1049,1286
202,1297,142,18,87,1050,1297
203,1299,142,25,79,1053,1299
204,1311,152,28,79,1052,1311
205,1322,158,33,77,1054,1322
206,1334,167,30,77,1060,1334
207,1341,176,27,80,1058,1341
208,1354,189,26,81,1058,1354
209,1364,197,26,82,1059,1364
210,1376,205,27,83,1061,1376
211,1380,198,36,85,1061,1380
212,1392,206,32,91,1063,1392
213,1405,209,39,92,1065,1405
214,1416,216,35,101,1064,1416
215,1423,218,40,103,1062,1423
216,1431,228,36,104,1063,1431
217,1442,232,33,118,1059,1442
218,1452,230,41,121,1060,1452
219,1466,230,48,127,1061,1466
220,1479,235,54,127,1063,1479
221,1484,243,52,130,1059,1484
222,1492,240,54,138,1060,1492
223,1499,236,60,142,1061,1499
224,1500,224,62,153,1061,1500
225,1500,210,70,160,1060,1500
226,1500,198,74,167,1061,1500
227,1500,182,72,184,1062,1500
228,1500,166,83,188,1063,1500
229,1500,154,85,198,1063,1500
230,1500,145,75,212,1068,1500
231,1500,147,60,221,1072,1500
232,1495,128,62,235,1070,1495
233,1500,128,61,245,1066,1500
234,1498,122,68,247,1061,1498
235,1498,116,67,250,1065,1498
236,1499,108,69,256,1066,1499
237,1500,101,68,263,1068,1500
238,1500,101,70,263,1066,1500
239,1499,105,65,268,1061,1499
240,1498,108,57,274,1059,1498
241,1493,112,55,265,1061,1493
242,1496,119,54,269,1054,1496
243,1500,122,57,264,1057,1500
244,1497,124,62,253,1058,1497
245,1490,122,65,246,1057,1490
246,1482,117,66,239,1060,1482
247,1487,128,62,238,1059,1487
248,1495,126,70,241,1058,1495
249,1496,131,63,250,1052,1496
250,1500,132,69,242,1057,1500
251,1500,140,65,239,1056,1500
252,1500,137,57,244,1062,1500
253,1497,126,59,246,1066,1497
254,1494,124,63,240,1067,1494
255,1500,128,70,238,1064,1500
256,1498,121,77,230,1070,1498
257,1500,116,72,243,1069,1500
258,1498,110,71,246,1071,1498
259,1500,107,66,252,1075,1500
260,1500,101,60,256,1083,1500
261,1498,108,53,258,1079,1498
262,1500,103,57,260,1080,1500
263,1498,102,56,249,1091,1498
264,1493,103,52,249,1089,1493
265,1495,102,59,248,1086,1495
266,1493,112,52,243,1086,1493
267,1499,118,57,235,1089,1499
268,1499,117,56,236,1090,1499
269,1499,117,50,240,1092,1499
270,1499,112,64,234,1089,1499
271,1499,119,55,231,1094,1499
272,1500,117,61,227,1095,1500
273,1496,111,62,222,1101,1496
274,1494,121,52,218,1103,1494
275,1496,113,61,211,1111,1496
276,1500,119,49,218,1114,1500
277,1498,119,52,215,1112,1498
278,1497,119,50,215,1113,1497
279,1500,121,44,218,1117,1500
280,1497,116,50,210,1121,1497
281,1499,116,55,212,1116,1499
282,1500,124,52,211,1113,1500
283,1499,126,53,202,1118,1499
284,1498,128,48,214,1108,1498
285,1499,131,49,207,1112,1499
286,1497,134,47,208,1108,1497
287,1500,123,62,203,1112,1500
288,1498,135,60,200,1103,1498
289,1500,149,59,200,1092,1500
290,1498,159,57,198,1084,1498
291,1499,163,55,206,1075,1499
292,1500,167,64,205,1064,1500
293,1492,175,69,199,1049,1492
294,1499,186,80,210,1023,1499
295,1498,196,92,208,1002,1498
296,1496,194,92,217,993,1496
297,1500,197,98,229,976,1500
298,1498,200,103,239,956,1498
299,1500,198,115,254,933,1500
300,1500,195,123,266,916,1500
301,1497,196,128,279,894,1497
302,1500,208,124,299,869,1500
303,1500,198,127,324,851,1500
304,1498,194,125,340,839,1498
305,1500,180,135,354,831,1500
306,1500,159,145,374,822,1500
307,1500,141,139,404,816,1500
308,1494,124,143,416,811,1494
309,1499,126,123,445,805,1499
310,1496,112,118,461,805,1496
311,1500,106,106,481,807,1500
312,1496,85,111,481,819,1496
313,1488,75,113,474,826,1488
314,1484,73,108,479,824,1484
315,1479,65,95,491,828,1479
316,1475,69,79,485,842,1475
317,1473,65,74,475,859,1473
318,1469,62,69,460,878,1469
319,1467,62,61,451,893,1467
320,1457,55,59,432,911,1457
321,1442,50,51,411,930,1442
322,1435,54,44,397,940,1435
323,1424,54,41,370,959,1424
324,1417,58,46,337,976,1417
325,1400,64,38,312,986,1400
326,1399,74,36,292,997,1399
327,1396,72,36,281,1007,1396
328,1391,72,41,262,1016,1391
329,1385,75,47,234,1029,1385
330,1389,85,46,216,1042,1389
331,1382,88,47,198,1049,1382
332,1382,92,39,193,1058,1382
333,1383,98,37,182,1066,1383
334,1390,102,38,177,1073,1390
335,1388,109,36,165,1078,1388
336,1394,113,38,157,1086,1394
337,1395,108,38,154,1095,1395
338,1406,111,40,157,1098,1406
339,1405,112,39,152,1102,1405
340,1414,122,39,152,1101,1414
341,1422,127,37,152,1106,1422
342,1437,142,37,150,1108,1437
343,1445,143,40,155,1107,1445
344,1460,156,42,152,1110,1460
345,1473,162,49,152,1110,1473
346,1475,163,54,145,1113,1475
347,1492,170,56,149,1117,1492
348,1498,173,67,146,1112,1498
349,1500,162,65,160,1113,1500
350,1500,152,72,167,1109,1500
351,1499,146,75,172,1106,1499
352,1500,141,70,181,1108,1500
353,1500,134,69,186,1111,1500
354,1500,116,67,203,1114,1500
355,1500,111,64,212,1113,1500
356,1500,101,72,217,1110,1500
357,1497,97,73,219,1108,1497
358,1499,95,73,231,1100,1499
359,1500,84,72,245,1099,1500
360,1500,87,62,253,1098,1500
361,1498,85,62,254,1097,1498
362,1498,84,54,267,1093,1498
363,1500,96,46,264,1094,1500
364,1499,96,47,259,1097,1499
365,1500,101,48,257,1094,1500
366,1498,93,59,251,1095,1498
367,1500,90,62,250,1098,1500
368,1499,93,63,235,1108,1499
369,1500,97,63,229,1111,1500
370,1500,96,57,240,1107,1500
371,1496,100,54,240,1102,1496
372,1499,111,54,234,1100,1499
373,1492,119,51,222,1100,1492
374,1497,124,48,224,1101,1497
375,1500,133,40,221,1106,1500
376,1500,127,54,210,1109,1500
377,1498,126,53,202,1117,1498
378,1498,124,55,205,1114,1498
379,1495,125,60,201,1109,1495
380,1496,120,61,208,1107,1496
381,1499,118,65,206,1110,1499
382,1500,119,60,213,1108,1500
383,1500,121,64,211,1104,1500
384,1500,119,58,208,1115,1500
385,1500,115,56,211,1118,1500
386,1496,102,69,209,1116,1496
387,1500,104,66,213,1117,1500
388,1496,104,67,208,1117,1496
389,1498,108,61,212,1117,1498
390,1500,102,52,228,1118,1500
391,1500,113,49,229,1109,1500
392,1500,116,51,228,1105,1500
393,1500,113,52,234,1101,1500
394,1500,112,56,226,1106,1500
395,1498,110,64,224,1100,1498
396,1499,115,63,222,1099,1499
397,1498,112,59,227,1100,1498
398,1500,123,50,222,1105,1500
399,1497,124,48,220,1105,1497
400,1500,122,48,226,1104,1500
401,1498,117,53,220,1108,1498
402,1499,125,56,214,1104,1499
403,1497,131,56,211,1099,1497
404,1495,130,51,205,1109,1495
405,1499,142,51,206,1100,1499
406,1499,139,54,204,1102,1499
407,1500,140,52,204,1104,1500
408,1499,144,48,203,1104,1499
409,1499,140,48,209,1102,1499
410,1498,134,57,207,1100,1498
411,1499,128,67,201,1103,1499
412,1500,129,68,194,1109,1500
413,1498,129,64,194,1111,1498
414,1499,129,56,203,1111,1499
415,1499,128,49,211,1111,1499
416,1500,130,51,212,1107,1500
417,1500,129,48,214,1109,1500
418,1499,136,44,212,1107,1499
419,1497,125,60,206,1106,1497
420,1500,119,73,206,1102,1500
421,1499,114,75,205,1105,1499
422,1500,112,72,209,1107,1500
423,1499,112,65,213,1109,1499
424,1500,122,49,223,1106,1500
425,1500,124,42,232,1102,1500
426,1500,115,52,236,1097,1500
427,1498,114,59,228,1097,1498
428,1497,116,65,215,1101,1497
429,1500,110,75,211,1104,1500
430,1499,112,69,222,1096,1499
431,1494,119,71,219,1085,1494
432,1500,118,74,232,1076,1500
433,1500,121,76,239,1064,1500
434,1499,112,84,240,1063,1499
435,1492,103,83,246,1060,1492
436,1495,106,70,263,1056,1495
437,1491,111,77,259,1044,1491
438,1489,121,80,255,1033,1489
439,1494,131,86,253,1024,1494
440,1496,136,89,259,1012,1496
441,1499,137,94,274,994,1499
442,1499,132,91,286,990,1499
443,1496,135,90,297,974,1496
444,1498,147,85,302,964,1498
445,1498,136,94,313,955,1498
446,1492,138,97,305,952,1492
447,1499,134,99,318,948,1499
448,1499,128,105,322,944,1499
449,1500,129,93,337,941,1500
450,1498,132,85,334,947,1498
451,1499,125,88,339,947,1499
452,1498,112,98,342,946,1498
453,1497,113,93,348,943,1497
454,1494,109,86,355,944,1494
455,1494,103,89,352,950,1494
456,1487,97,83,358,949,1487
457,1488,92,84,357,955,1488
458,1481,83,90,348,960,1481
459,1477,89,78,344,966,1477
460,1477,91,62,352,972,1477
461,1475,91,64,344,976,1475
462,1472,79,69,347,977,1472
463,1464,81,69,325,989,1464
464,1454,75,73,310,996,1454
465,1453,72,64,314,1003,1453
466,1446,77,56,311,1002,1446
467,1443,80,55,303,1005,1443
468,1437,78,57,290,1012,1437
469,1435,75,54,288,1018,1435
470,1432,81,58,267,1026,1432
471,1428,79,57,261,1031,1428
472,1424,77,56,259,1032,1424
473,1422,82,53,253,1034,1422
474,1418,83,57,236,1042,1418
475,1420,89,52,235,1044,1420
476,1418,93,51,226,1048,1418
477,1424,95,50,230,1049,1424
478,1432,94,54,229,1055,1432
479,1428,97,55,215,1061,1428
480,1420,97,54,206,1063,1420
481,1427,112,49,205,1061,1427
482,1425,101,51,210,1063,1425
483,1431,107,58,203,1063,1431
484,1441,123,59,205,1054,1441
485,1442,117,65,201,1059,1442
486,1446,118,67,204,1057,1446
487,1449,124,62,208,1055,1449
488,1458,129,71,210,1048,1458
489,1458,125,74,213,1046,1458
490,1466,132,73,219,1042,1466
491,1469,123,82,219,1045,1469
492,1471,125,76,229,1041,1471
493,1472,122,74,239,1037,1472
494,1478,131,72,242,1033,1478
495,1479,128,69,253,1029,1479
496,1481,129,72,255,1025,1481
497,1491,136,77,262,1016,1491
498,1498,130,89,262,1017,1498
499,1500,122,88,271,1019,1500
500,1498,120,78,280,1020,1498
501,1499,117,74,284,1024,1499
502,1500,119,70,290,1021,1500
503,1492,105,75,292,1020,1492
504,1500,104,94,290,1012,1500
505,1497,103,86,297,1011,1497
506,1498,103,89,288,1018,1498
507,1498,106,77,292,1023,1498
508,1500,103,67,311,1019,1500
509,1495,96,72,303,1024,1495
510,1496,102,68,298,1028,1496
511,1498,97,70,298,1033,1498
512,1493,82,71,308,1032,1493
513,1488,82,74,302,1030,1488
514,1480,91,75,291,1023,1480
515,1481,86,70,293,1032,1481
516,1485,100,64,292,1029,1485
517,1484,90,70,287,1037,1484
518,1484,94,71,288,1031,1484
519,1487,108,60,281,1038,1487
520,1490,107,62,286,1035,1490
521,1488,105,60,281,1042,1488
522,1469,101,63,261,1044,1469
523,1475,108,63,259,1045,1475
524,1479,113,67,263,1036,1479
525,1481,109,68,260,1044,1481
526,1489,118,64,257,1050,1489
527,1490,120,71,254,1045,1490
528,1495,120,68,263,1044,1495
529,1496,116,74,254,1052,1496
530,1500,117,75,253,1055,1500
531,1500,123,70,253,1054,1500
532,1500,133,58,260,1049,1500
533,1498,128,54,264,1052,1498
534,1493,118,63,259,1053,1493
535,1493,113,73,254,1053,1493
536,1493,112,71,253,1057,1493
537,1496,114,71,253,1058,1496
538,1497,110,72,257,1058,1497
539,1500,106,69,266,1059,1500
540,1497,103,76,257,1061,1497
541,1499,97,76,261,1065,1499
542,1495,101,62,264,1068,1495
543,1496,102,59,268,1067,1496
544,1495,107,56,265,1067,1495
545,1492,105,58,263,1066,1492
546,1491,102,62,254,1073,1491
547,1494,101,65,251,1077,1494
548,1499,108,68,249,1074,1499
549,1498,107,70,251,1070,1498
550,1500,97,73,256,1074,1500
551,1496,90,72,258,1076,1496
552,1494,88,70,257,1079,1494
553,1496,94,68,249,1085,1496
554,1500,89,70,256,1085,1500
555,1499,90,57,260,1092,1499
556,1495,101,51,252,1091,1495
557,1500,108,52,248,1092,1500
558,1498,108,53,247,1090,1498
559,1500,120,52,241,1087,1500
560,1500,118,55,241,1086,1500
561,1500,117,50,242,1091,1500
562,1499,109,57,240,1093,1499
563,1499,104,63,238,1094,1499
564,1500,103,71,233,1093,1500
565,1500,96,75,228,1101,1500
566,1494,112,58,228,1096,1494
567,1498,108,62,232,1096,1498
568,1500,102,65,235,1098,1500
569,1495,108,67,226,1094,1495
570,1496,119,74,218,1085,1496
571,1500,131,57,229,1083,1500
572,1500,136,48,233,1083,1500
573,1500,129,54,236,1081,1500
574,1500,123,59,237,1081,1500
575,1493,122,67,230,1074,1493
576,1495,123,69,233,1070,1495
577,1494,124,69,237,1064,1494
578,1497,120,72,244,1061,1497
579,1498,124,66,251,1057,1498
580,1490,120,71,242,1057,1490
581,1494,131,65,246,1052,1494
582,1500,131,69,243,1057,1500
583,1500,129,73,247,1051,1500
584,1499,124,78,253,1044,1499
585,1492,130,71,248,1043,1492
586,1496,130,73,248,1045,1496
587,1496,132,72,257,1035,1496
588,1499,138,71,261,1029,1499
589,1500,133,73,268,1026,1500
590,1499,130,74,273,1022,1499
591,1499,130,74,274,1021,1499
592,1499,123,81,273,1022,1499
593,1499,118,88,273,1020,1499
594,1499,113,92,280,1014,1499
595,1498,118,80,280,1020,1498
596,1498,116,78,285,1019,1498
597,1496,105,77,296,1018,1496
598,1496,101,75,300,1020,1496
599,1496,112,76,293,1015,1496
600,1499,110,75,293,1021,1499
601,1493,98,70,298,1027,1493
602,1497,95,71,298,1033,1497
603,1499,104,66,294,1035,1499
604,1496,97,57,298,1044,1496
605,1499,97,60,297,1045,1499
606,1499,101,57,293,1048,1499
607,1499,95,71,285,1048,1499
608,1493,92,74,278,1049,1493
609,1491,89,71,277,1054,1491
610,1492,91,69,271,1061,1492
611,1490,94,61,267,1068,1490
612,1491,88,68,261,1074,1491
613,1496,90,63,267,1076,1496
614,1496,90,63,263,1080,1496
615,1496,95,63,251,1087,1496
616,1500,105,53,255,1087,1500
617,1500,99,58,253,1090,1500
618,1491,89,62,248,1092,1491
619,1498,102,60,240,1096,1498
620,1499,105,55,245,1094,1499
621,1500,105,57,250,1088,1500
622,1499,98,62,249,1090,1499
623,1497,95,67,242,1093,1497
624,1500,106,63,238,1093,1500
625,1492,103,57,236,1096,1492
626,1497,114,53,237,1093,1497
627,1498,125,49,235,1089,1498
628,1499,125,46,234,1094,1499
629,1500,129,53,230,1088,1500
630,1496,128,60,219,1089,1496
631,1496,133,59,221,1083,1496
632,1491,130,64,216,1081,1491
633,1498,138,61,221,1078,1498
634,1500,134,63,222,1081,1500
635,1500,140,65,222,1073,1500
636,1500,142,63,225,1070,1500
637,1496,144,69,221,1062,1496
638,1499,145,59,232,1063,1499
639,1494,141,68,231,1054,1494
640,1495,136,78,225,1056,1495
641,1496,141,78,226,1051,1496
642,1498,142,79,226,1051,1498
643,1498,133,73,244,1048,1498
644,1500,129,69,252,1050,1500
645,1493,124,73,254,1042,1493
646,1500,127,79,258,1036,1500
647,1499,122,73,266,1038,1499
648,1494,121,68,261,1044,1494
649,1499,108,80,268,1043,1499
650,1495,112,72,274,1037,1495
651,1500,113,76,276,1035,1500
652,1493,105,78,271,1039,1493
653,1492,103,68,279,1042,1492
654,1500,108,67,285,1040,1500
655,1499,106,62,285,1046,1499
656,1499,103,65,285,1046,1499
657,1494,102,61,281,1050,1494
658,1495,100,77,274,1044,1495
659,1497,93,84,272,1048,1497
660,1499,94,83,270,1052,1499
661,1496,97,70,272,1057,1496
662,1500,104,54,286,1056,1500
663,1498,109,54,277,1058,1498
664,1500,108,55,272,1065,1500
665,1500,106,62,265,1067,1500
666,1495,109,55,267,1064,1495
667,1498,114,62,255,1067,1498
668,1500,111,64,258,1067,1500
669,1500,107,67,251,1075,1500
670,1499,104,71,250,1074,1499
671,1495,111,61,245,1078,1495
672,1491,116,53,252,1070,1491
673,1494,120,50,257,1067,1494
674,1500,116,59,254,1071,1500
675,1499,121,60,241,1077,1499
676,1496,130,58,226,1082,1496
677,1497,135,63,224,1075,1497
678,1499,135,57,230,1077,1499
679,1499,120,70,235,1074,1499
680,1497,115,79,228,1075,1497
681,1500,110,77,236,1077,1500
682,1496,102,83,232,1079,1496
683,1499,100,75,243,1081,1499
684,1498,99,70,251,1078,1498
685,1498,102,69,253,1074,1498
686,1496,109,62,254,1071,1496
687,1497,111,65,246,1075,1497
688,1493,110,60,255,1068,1493
689,1497,121,56,259,1061,1497
690,1500,113,67,262,1058,1500
691,1500,107,72,261,1060,1500
692,1497,112,73,254,1058,1497
693,1500,110,69,262,1059,1500
694,1498,97,72,273,1056,1498
695,1496,99,67,267,1063,1496
696,1499,93,75,266,1065,1499
697,1496,96,70,263,1067,1496
698,1499,101,57,268,1073,1499
699,1492,104,61,257,1070,1492
700,1500,113,59,257,1071,1500
701,1499,110,61,260,1068,1499
702,1499,120,59,252,1068,1499
703,1498,113,66,250,1069,1498
704,1500,108,67,251,1074,1500
705,1497,93,80,255,1069,1497
706,1499,99,80,254,1066,1499
707,1500,97,71,259,1073,1500
708,1499,96,67,254,1082,1499
709,1498,90,63,259,1086,1498
710,1499,89,66,258,1086,1499
711,1500,102,57,255,1086,1500
712,1499,96,58,247,1098,1499
713,1498,92,61,251,1094,1498
714,1499,88,67,247,1097,1499
715,1499,101,61,245,1092,1499
716,1499,101,54,253,1091,1499
717,1500,99,54,255,1092,1500
718,1499,102,51,254,1092,1499
719,1500,106,55,248,1091,1500
720,1499,112,52,247,1088,1499
721,1496,111,53,240,1092,1496
722,1494,113,62,231,1088,1494
723,1485,111,68,223,1083,1485
724,1487,114,63,228,1082,1487
725,1493,122,69,224,1078,1493
726,1496,122,66,227,1081,1496
727,1499,131,62,228,1078,1499
728,1499,125,67,228,1079,1499
729,1497,124,69,232,1072,1497
730,1500,133,63,231,1073,1500
731,1495,132,70,227,1066,1495
732,1496,138,62,233,1063,1496
733,1500,130,68,240,1062,1500
734,1500,125,72,242,1061,1500
735,1500,122,80,240,1058,1500
736,1498,124,70,253,1051,1498
737,1498,120,73,254,1051,1498
738,1498,119,67,257,1055,1498
739,1500,115,68,268,1049,1500
740,1499,118,68,259,1054,1499
741,1499,115,66,262,1056,1499
742,1496,110,66,266,1054,1496
743,1500,109,73,266,1052,1500
744,1497,108,77,259,1053,1497
745,1499,103,84,263,1049,1499
746,1497,102,81,261,1053,1497
747,1494,101,77,269,1047,1494
748,1496,98,79,275,1044,1496
749,1499,96,76,282,1045,1499
750,1497,104,76,273,1044,1497
751,1497,102,73,277,1045,1497
752,1499,102,59,283,1055,1499
753,1497,99,60,277,1061,1497
754,1500,102,57,281,1060,1500
755,1495,97,56,277,1065,1495
756,1495,98,59,272,1066,1495
757,1496,98,57,269,1072,1496
758,1498,103,56,269,1070,1498
759,1500,106,51,270,1073,1500
760,1500,110,49,265,1076,1500
761,1500,112,57,251,1080,1500
762,1500,115,60,242,1083,1500
763,1496,113,54,237,1092,1496
764,1496,112,61,234,1089,1496
765,1498,113,57,232,1096,1498
766,1495,118,53,220,1104,1495
767,1497,122,57,214,1104,1497
768,1498,121,56,217,1104,1498
769,1497,128,57,214,1098,1497
770,1498,130,55,211,1102,1498
771,1499,130,54,214,1101,1499
772,1499,126,56,219,1098,1499
773,1497,129,63,210,1095,1497
774,1500,126,68,205,1101,1500
775,1498,123,67,213,1095,1498
776,1500,129,54,224,1093,1500
777,1498,131,54,222,1091,1498
778,1500,132,51,225,1092,1500
779,1500,138,52,219,1091,1500
780,1498,132,58,218,1090,1498
781,1500,138,64,219,1079,1500
782,1499,140,64,214,1081,1499
783,1500,139,61,221,1079,1500
784,1500,137,62,228,1073,1500
785,1498,133,66,225,1074,1498
786,1494,129,68,224,1073,1494
787,1500,135,71,229,1065,1500
788,1500,130,63,242,1065,1500
789,1500,132,65,238,1065,1500
790,1498,129,60,235,1074,1498
791,1499,128,60,235,1076,1499
792,1498,125,57,241,1075,1498
793,1497,112,66,243,1076,1497
794,1496,122,59,245,1070,1496
795,1499,125,68,245,1061,1499
796,1499,123,74,252,1050,1499
797,1499,118,78,249,1054,1499
798,1500,115,77,249,1059,1500
799,1500,108,75,254,1063,1500
800,1496,104,68,262,1062,1496
801,1499,104,67,267,1061,1499
802,1490,107,67,261,1055,1490
803,1492,110,66,264,1052,1492
804,1490,104,64,264,1058,1490
805,1495,110,61,266,1058,1495
806,1499,118,59,258,1064,1499
807,1498,119,58,263,1058,1498
808,1498,113,59,263,1063,1498
809,1498,99,65,262,1072,1498
810,1500,102,62,261,1075,1500
811,1500,97,66,258,1079,1500
812,1499,104,59,258,1078,1499
813,1499,99,67,253,1080,1499
814,1498,101,62,246,1089,1498
815,1498,104,64,244,1086,1498
816,1499,101,70,242,1086,1499
817,1500,105,70,241,1084,1500
818,1498,109,68,237,1084,1498
819,1500,104,65,238,1093,1500
820,1500,106,59,248,1087,1500
821,1500,108,51,248,1093,1500
822,1499,104,60,241,1094,1499
823,1500,104,59,245,1092,1500
824,1499,107,55,243,1094,1499
825,1500,104,59,241,1096,1500
826,1499,98,61,238,1102,1499
827,1500,96,58,240,1106,1500
828,1500,97,61,239,1103,1500
829,1500,103,57,234,1106,1500
830,1500,106,51,237,1106,1500
831,1493,104,53,237,1099,1493
832,1491,113,58,233,1087,1491
833,1487,110,63,221,1093,1487
834,1488,117,61,218,1092,1488
835,1491,128,54,219,1090,1491
836,1498,125,59,225,1089,1498
837,1495,128,61,219,1087,1495
838,1499,136,56,220,1087,1499
839,1498,138,54,224,1082,1498
840,1500,138,55,225,1082,1500
841,1500,147,55,222,1076,1500
842,1492,142,61,217,1072,1492
843,1496,145,62,218,1071,1496
844,1494,146,62,217,1069,1494
845,1499,141,73,216,1069,1499
846,1497,146,66,223,1062,1497
847,1500,135,77,228,1060,1500
848,1500,133,75,231,1061,1500
849,1496,125,75,233,1063,1496
850,1498,125,82,232,1059,1498
851,1499,122,76,247,1054,1499
852,1496,118,75,250,1053,1496
853,1500,120,72,256,1052,1500
854,1499,122,72,255,1050,1499
855,1500,125,65,263,1047,1500
856,1499,114,65,270,1050,1499
857,1495,102,67,276,1050,1495
858,1500,104,72,272,1052,1500
859,1500,99,69,277,1055,1500
860,1499,108,63,274,1054,1499
861,1500,103,67,280,1050,1500
862,1498,104,60,279,1055,1498
863,1500,115,56,272,1057,1500
864,1500,107,60,276,1057,1500
865,1497,99,63,267,1068,1497
866,1493,107,65,258,1063,1493
867,1494,108,66,254,1066,1494
868,1499,108,72,253,1066,1499
869,1498,111,68,251,1068,1498
870,1500,113,74,248,1065,1500
871,1499,104,73,250,1072,1499
872,1498,102,73,253,1070,1498
873,1497,104,72,251,1070,1497
874,1497,103,72,252,1070,1497
875,1493,101,67,257,1068,1493
876,1495,105,67,253,1070,1495
877,1496,113,63,255,1065,1496
878,1496,104,68,253,1071,1496
879,1497,101,71,256,1069,1497
880,1499,111,66,257,1065,1499
881,1499,122,59,259,1059,1499
882,1497,124,56,263,1054,1497
883,1489,123,63,260,1043,1489
884,1492,125,63,259,1045,1492
885,1487,117,77,248,1045,1487
886,1493,126,78,247,1042,1493
887,1497,129,68,256,1044,1497
888,1500,130,67,258,1045,1500
889,1498,128,67,251,1052,1498
890,1500,128,68,255,1049,1500
891,1494,119,72,254,1049,1494
892,1496,119,72,254,1051,1496
893,1498,120,74,253,1051,1498
894,1500,118,73,261,1048,1500
895,1500,119,70,258,1053,1500
896,1497,117,63,260,1057,1497
897,1500,119,64,260,1057,1500
898,1500,112,61,267,1060,1500
899,1499,107,65,271,1056,1499
900,1499,109,66,268,1056,1499
901,1498,110,64,260,1064,1498
902,1498,107,72,256,1063,1498
903,1500,102,70,261,1067,1500
904,1488,105,70,253,1060,1488
905,1495,109,62,258,1066,1495
906,1499,108,53,266,1072,1499
907,1498,107,56,262,1073,1498
908,1498,104,62,254,1078,1498
909,1500,108,64,250,1078,1500
910,1498,113,66,245,1074,1498
911,1500,114,70,246,1070,1500
912,1499,103,74,244,1078,1499
913,1500,99,73,246,1082,1500
914,1496,91,72,251,1082,1496
915,1500,92,69,254,1085,1500
916,1498,90,62,259,1087,1498
917,1495,96,65,252,1082,1495
918,1499,97,67,259,1076,1499
919,1498,99,66,255,1078,1498
920,1498,91,78,245,1084,1498
921,1498,93,76,246,1083,1498
922,1500,96,63,257,1084,1500
923,1499,93,59,263,1084,1499
924,1498,93,56,268,1081,1498
925,1500,98,57,264,1081,1500
926,1499,98,60,259,1082,1499
927,1500,95,60,258,1087,1500
928,1494,84,66,256,1088,1494
929,1498,95,69,246,1088,1498
930,1499,107,64,244,1084,1499
931,1500,110,65,246,1079,1500
932,1500,109,61,248,1082,1500
933,1500,105,65,246,1084,1500
934,1500,106,64,249,1081,1500
935,1499,107,62,250,1080,1499
936,1493,107,59,244,1083,1493
937,1490,107,66,237,1080,1490
938,1499,121,63,235,1080,1499
939,1500,127,63,239,1071,1500
940,1500,121,63,240,1076,1500
941,1500,122,63,241,1074,1500
942,1500,125,61,243,1071,1500
943,1499,125,57,248,1069,1499
944,1499,123,73,240,1063,1499
945,1500,119,67,245,1069,1500
946,1500,123,70,238,1069,1500
947,1498,127,68,241,1062,1498
948,1500,138,58,245,1059,1500
949,1496,145,57,243,1051,1496
950,1499,145,60,245,1049,1499
951,1498,126,74,246,1052,1498
952,1492,127,77,236,1052,1492
953,1493,126,80,234,1053,1493
954,1500,124,81,246,1049,1500
955,1499,115,79,253,1052,1499
956,1491,105,86,248,1052,1491
957,1494,107,79,252,1056,1494
958,1495,113,65,268,1049,1495
959,1491,103,59,272,1057,1491
960,1494,107,58,275,1054,1494
961,1494,100,73,268,1053,1494
962,1497,100,71,265,1061,1497
963,1500,102,74,261,1063,1500
964,1498,104,65,267,1062,1498
965,1500,106,61,274,1059,1500
966,1500,97,59,283,1061,1500
967,1499,90,65,279,1065,1499
968,1495,93,58,271,1073,1495
969,1497,92,57,264,1084,1497
970,1499,89,58,267,1085,1499
971,1489,88,50,262,1089,1489
972,1489,95,51,248,1095,1489
973,1488,97,49,241,1101,1488
974,1484,95,56,234,1099,1484
975,1489,102,57,231,1099,1489
976,1488,98,58,232,1100,1488
977,1490,105,55,233,1097,1490
978,1495,116,54,225,1100,1495
979,1489,113,58,216,1102,1489
980,1493,120,58,214,1101,1493
981,1500,125,58,214,1103,1500
982,1500,128,53,215,1104,1500
983,1499,122,60,215,1102,1499
984,1500,125,62,210,1103,1500
985,1500,131,72,205,1092,1500
986,1499,126,74,209,1090,1499
987,1497,125,68,214,1090,1497
988,1497,110,79,219,1089,1497
989,1500,112,72,231,1085,1500
990,1498,113,67,231,1087,1498
991,1500,114,61,239,1086,1500
992,1499,118,51,243,1087,1499
993,1500,120,55,245,1080,1500
994,1497,114,56,244,1083,1497
995,1499,118,56,248,1077,1499
996,1500,116,62,239,1083,1500
997,1499,122,55,239,1083,1499
998,1499,114,62,244,1079,1499
999,1500,114,63,248,1075,1500
1000,1500,108,64,248,1080,1500
1001,1499,106,70,236,1087,1499
1002,1500,106,66,240,1088,1500
1003,1498,104,60,241,1093,1498
1004,1499,112,55,236,1096,1499
1005,1500,113,54,235,1098,1500
1006,1499,121,50,231,1097,1499
1007,1500,123,54,228,1095,1500
1008,1500,127,56,224,1093,1500
1009,1498,129,58,225,1086,1498
1010,1498,118,66,229,1085,1498
1011,1499,117,70,227,1085,1499
1012,1500,118,68,227,1087,1500
1013,1500,119,62,231,1088,1500
1014,1499,118,56,237,1088,1499
1015,1500,116,59,239,1086,1500
1016,1499,124,58,232,1085,1499
1017,1500,121,62,230,1087,1500
1018,1500,117,75,226,1082,1500
1019,1500,125,68,224,1083,1500
1020,1496,118,72,224,1082,1496
1021,1500,119,68,238,1075,1500
1022,1498,115,70,243,1070,1498
1023,1499,117,74,244,1064,1499
1024,1498,108,75,247,1068,1498
1025,1500,114,72,252,1062,1500
1026,1499,120,68,253,1058,1499
1027,1496,120,64,253,1059,1496
1028,1495,127,58,252,1058,1495
1029,1499,132,59,255,1053,1499
1030,1500,126,67,257,1050,1500
1031,1500,125,72,251,1052,1500
1032,1500,123,73,259,1045,1500
1033,1498,130,67,261,1040,1498
1034,1500,126,65,264,1045,1500
1035,1500,127,68,256,1049,1500
1036,1500,125,66,261,1048,1500
1037,1496,112,73,260,1051,1496
1038,1496,118,67,258,1053,1496
1039,1499,132,58,256,1053,1499
1040,1500,130,58,259,1053,1500
1041,1499,128,52,259,1060,1499
1042,1495,128,57,249,1061,1495
1043,1499,134,55,246,1064,1499
1044,1497,131,54,249,1063,1497
1045,1496,126,64,249,1057,1496
1046,1499,124,76,244,1055,1499
1047,1500,123,86,237,1054,1500
1048,1498,118,82,241,1057,1498
1049,1498,119,87,242,1050,1498
1050,1498,112,82,249,1055,1498
1051,1498,110,78,255,1055,1498
1052,1500,109,75,260,1056,1500
1053,1498,111,74,262,1051,1498
1054,1495,116,66,263,1050,1495
1055,1496,117,66,263,1050,1496
1056,1500,113,74,267,1046,1500
1057,1500,107,69,273,1051,1500
1058,1498,105,73,271,1049,1498
1059,1497,94,76,277,1050,1497
1060,1499,98,65,286,1050,1499
1061,1500,91,68,292,1049,1500
1062,1499,102,56,286,1055,1499
1063,1499,98,56,286,1059,1499
1064,1494,92,60,272,1070,1494
1065,1493,95,64,267,1067,1493
1066,1499,106,71,258,1064,1499
1067,1497,102,77,252,1066,1497
1068,1499,105,71,252,1071,1499
1069,1500,106,61,253,1080,1500
1070,1500,98,59,260,1083,1500
1071,1500,99,58,257,1086,1500
1072,1496,97,59,256,1084,1496
1073,1494,91,73,246,1084,1494
1074,1498,95,65,246,1092,1498
1075,1500,100,64,244,1092,1500
1076,1500,104,62,237,1097,1500
1077,1498,104,50,248,1096,1498
1078,1499,94,61,245,1099,1499
1079,1499,94,68,240,1097,1499
1080,1499,94,71,239,1095,1499
1081,1498,94,66,246,1092,1498
1082,1494,102,54,246,1092,1494
1083,1488,101,49,243,1095,1488
1084,1491,109,46,237,1099,1491
1085,1492,109,52,230,1101,1492
1086,1500,119,49,228,1104,1500
1087,1500,114,57,230,1099,1500
1088,1499,121,58,222,1098,1499
1089,1498,128,60,223,1087,1498
1090,1497,125,67,221,1084,1497
1091,1493,133,60,212,1088,1493
1092,1499,142,64,214,1079,1499
1093,1498,135,68,219,1076,1498
1094,1500,136,57,231,1076,1500
1095,1500,139,61,221,1079,1500
1096,1498,139,59,218,1082,1498
1097,1493,127,61,220,1085,1493
1098,1500,141,65,215,1079,1500
1099,1496,134,68,219,1075,1496
1100,1499,129,69,227,1074,1499
1101,1499,123,69,235,1072,1499
1102,1500,120,70,238,1072,1500
1103,1499,120,71,236,1072,1499
1104,1500,115,70,245,1070,1500
1105,1494,108,64,250,1072,1494
1106,1500,111,64,252,1073,1500
1107,1500,103,69,251,1077,1500
1108,1499,100,67,248,1084,1499
1109,1498,98,66,252,1082,1498
1110,1497,97,66,252,1082,1497
1111,1500,104,60,251,1085,1500
1112,1499,99,59,260,1081,1499
1113,1499,92,60,261,1086,1499
1114,1500,97,57,258,1088,1500
1115,1498,103,58,248,1089,1498
1116,1496,108,53,253,1082,1496
1117,1500,110,52,254,1084,1500
1118,1495,108,56,247,1084,1495
1119,1500,117,58,236,1089,1500
1120,1497,118,60,235,1084,1497
1121,1496,127,55,239,1075,1496
1122,1494,131,60,228,1075,1494
1123,1499,134,66,227,1072,1499
1124,1496,136,69,224,1067,1496
1125,1498,136,65,229,1068,1498
1126,1497,141,66,221,1069,1497
1127,1499,139,67,225,1068,1499
1128,1500,137,70,225,1068,1500
1129,1500,125,75,233,1067,1500
1130,1500,111,85,227,1077,1500
1131,1498,100,85,233,1080,1498
1132,1500,99,83,242,1076,1500
1133,1499,104,76,248,1071,1499
1134,1500,105,64,260,1071,1500
1135,1499,107,61,262,1069,1499
1136,1500,100,63,271,1066,1500
1137,1499,100,70,268,1061,1499
1138,1500,99,66,271,1064,1500
1139,1488,99,61,266,1062,1488
1140,1495,107,55,274,1059,1495
1141,1497,112,51,273,1061,1497
1142,1496,108,55,267,1066,1496
1143,1492,106,56,265,1065,1492
1144,1495,110,54,263,1068,1495
1145,1498,114,63,252,1069,1498
1146,1499,113,64,248,1074,1499
1147,1496,114,59,247,1076,1496
1148,1493,127,59,234,1073,1493
1149,1488,122,60,231,1075,1488
1150,1492,134,56,228,1074,1492
1151,1500,135,64,230,1071,1500
1152,1494,124,67,231,1072,1494
1153,1499,124,68,229,1078,1499
1154,1498,121,75,225,1077,1498
1155,1498,139,65,227,1067,1498
1156,1498,134,65,235,1064,1498
1157,1498,125,69,240,1064,1498
1158,1500,124,71,239,1066,1500
1159,1500,120,74,244,1062,1500
1160,1498,122,73,245,1058,1498
1161,1498,132,64,251,1051,1498
1162,1498,132,58,256,1052,1498
1163,1498,123,69,252,1054,1498
1164,1499,127,62,256,1054,1499
1165,1498,122,62,257,1057,1498
1166,1500,119,63,258,1060,1500
1167,1499,116,65,257,1061,1499
1168,1497,125,61,255,1056,1497
1169,1499,123,62,253,1061,1499
1170,1500,119,63,256,1062,1500
1171,1500,126,63,248,1063,1500
1172,1500,121,70,250,1059,1500
1173,1500,116,71,249,1064,1500
1174,1498,112,65,256,1065,1498
1175,1496,111,75,244,1066,1496
1176,1497,114,68,248,1067,1497
1177,1500,116,75,245,1064,1500
1178,1491,108,77,245,1061,1491
1179,1498,107,73,255,1063,1498
1180,1496,104,73,255,1064,1496
1181,1500,101,78,256,1065,1500
1182,1500,107,72,262,1059,1500
1183,1499,103,74,265,1057,1499
1184,1495,100,76,268,1051,1495
1185,1499,104,77,272,1046,1499
1186,1500,106,77,274,1043,1500
1187,1500,103,76,279,1042,1500
1188,1497,111,63,279,1044,1497
1189,1499,111,67,287,1034,1499
1190,1500,109,68,285,1038,1500
1191,1500,105,73,286,1036,1500
1192,1499,104,68,283,1044,1499
1193,1497,110,62,283,1042,1497
1194,1495,117,60,281,1037,1495
1195,1496,111,68,281,1036,1496
1196,1497,117,67,277,1036,1497
1197,1497,124,65,269,1039,1497
1198,1487,119,62,266,1040,1487
1199,1487,110,66,270,1041,1487
1200,1493,117,64,268,1044,1493
1201,1500,123,69,259,1049,1500
1202,1491,122,65,255,1049,1491
1203,1489,130,61,257,1041,1489
1204,1497,134,70,251,1042,1497
1205,1499,125,79,251,1044,1499
1206,1499,127,77,250,1045,1499
1207,1496,123,70,248,1055,1496
1208,1499,127,67,253,1052,1499
1209,1500,123,64,256,1057,1500
1210,1500,122,61,254,1063,1500
1211,1500,115,69,260,1056,1500
1212,1495,112,60,263,1060,1495
1213,1492,116,64,250,1062,1492
1214,1499,125,62,248,1064,1499
1215,1500,125,53,263,1059,1500
1216,1500,127,58,257,1058,1500
1217,1500,127,66,246,1061,1500
1218,1500,128,67,245,1060,1500
1219,1496,118,66,250,1062,1496
1220,1497,120,61,255,1061,1497
1221,1498,123,59,249,1067,1498
1222,1497,123,65,241,1068,1497
1223,1496,120,73,237,1066,1496
1224,1494,125,71,238,1060,1494
1225,1500,126,71,240,1063,1500
1226,1496,126,69,233,1068,1496
1227,1500,119,75,245,1061,1500
1228,1499,119,76,251,1053,1499
1229,1498,122,68,245,1063,1498
1230,1499,120,69,249,1061,1499
1231,1500,120,65,260,1055,1500
1232,1500,122,63,265,1050,1500
1233,1497,113,78,257,1049,1497
1234,1500,126,66,263,1045,1500
1235,1499,121,68,261,1049,1499
1236,1499,122,66,260,1051,1499
1237,1500,121,55,271,1053,1500
1238,1499,119,55,272,1053,1499
1239,1500,110,71,265,1054,1500
1240,1499,105,79,258,1057,1499
1241,1498,103,77,257,1061,1498
1242,1500,104,74,256,1066,1500
1243,1498,106,59,262,1071,1498
1244,1498,107,52,261,1078,1498
1245,1498,115,51,255,1077,1498
1246,1498,121,51,253,1073,1498
1247,1500,115,59,252,1074,1500
1248,1500,126,58,239,1077,1500
1249,1500,121,60,239,1080,1500
1250,1496,123,59,243,1071,1496
1251,1494,121,61,232,1080,1494
1252,1499,125,61,230,1083,1499
1253,1499,122,61,232,1084,1499
1254,1499,114,66,235,1084,1499
1255,1500,112,59,239,1090,1500
1256,1495,115,54,237,1089,1495
1257,1493,120,58,222,1093,1493
1258,1490,112,58,223,1097,1490
1259,1489,111,56,224,1098,1489
1260,1487,115,57,218,1097,1487
1261,1500,121,61,225,1093,1500
1262,1498,122,57,229,1090,1498
1263,1499,119,61,228,1091,1499
1264,1500,118,65,223,1094,1500
1265,1499,117,61,228,1093,1499
1266,1500,115,68,227,1090,1500
1267,1499,121,58,235,1085,1499
1268,1500,118,70,230,1082,1500
1269,1497,112,70,229,1086,1497
1270,1497,108,76,226,1087,1497
1271,1499,111,71,231,1086,1499
1272,1500,102,67,238,1093,1500
1273,1498,113,58,241,1086,1498
1274,1500,110,62,246,1082,1500
1275,1498,110,56,248,1084,1498
1276,1499,108,56,246,1089,1499
1277,1498,105,61,246,1086,1498
1278,1496,101,59,254,1082,1496
1279,1496,101,63,246,1086,1496
1280,1500,112,58,244,1086,1500
1281,1494,112,50,244,1088,1494
1282,1497,113,50,252,1082,1497
1283,1500,117,58,241,1084,1500
1284,1497,111,69,236,1081,1497
1285,1500,111,67,239,1083,1500
1286,1497,117,64,230,1086,1497
1287,1496,119,59,232,1086,1496
1288,1498,117,60,232,1089,1498
1289,1500,108,66,231,1095,1500
1290,1496,104,77,228,1087,1496
1291,1499,104,76,233,1086,1499
1292,1499,103,76,229,1091,1499
1293,1499,99,70,241,1089,1499
1294,1499,102,63,253,1081,1499
1295,1486,102,61,244,1079,1486
1296,1484,107,54,246,1077,1484
1297,1492,116,54,250,1072,1492
1298,1496,116,52,260,1068,1496
1299,1494,106,66,254,1068,1494
1300,1499,120,62,249,1068,1499
1301,1499,115,70,240,1074,1499
1302,1498,116,59,251,1072,1498
1303,1494,118,56,251,1069,1494
1304,1499,115,73,247,1064,1499
1305,1499,110,69,252,1068,1499
1306,1496,107,67,253,1069,1496
1307,1498,105,71,242,1080,1498
1308,1496,117,66,240,1073,1496
1309,1500,116,62,249,1073,1500
1310,1497,115,70,240,1072,1497
1311,1500,117,65,245,1073,1500
1312,1495,118,64,244,1069,1495
1313,1498,122,59,252,1065,1498
1314,1499,124,61,256,1058,1499
1315,1499,114,72,259,1054,1499
1316,1492,106,83,246,1057,1492
1317,1494,120,75,246,1053,1494
1318,1498,121,69,258,1050,1498
1319,1495,126,56,262,1051,1495
1320,1491,123,56,264,1048,1491
1321,1494,128,62,261,1043,1494
1322,1496,129,68,253,1046,1496
1323,1492,128,69,247,1048,1492
1324,1500,135,69,255,1041,1500
1325,1496,128,70,255,1043,1496
1326,1498,126,74,258,1040,1498
1327,1499,127,74,253,1045,1499
1328,1500,135,65,258,1042,1500
1329,1500,135,63,262,1040,1500
1330,1499,133,62,269,1035,1499
1331,1500,135,63,267,1035,1500
1332,1500,137,59,265,1039,1500
1333,1495,136,69,248,1042,1495
1334,1500,133,74,247,1046,1500
1335,1500,120,80,256,1044,1500
1336,1494,118,77,259,1040,1494
1337,1490,119,75,261,1035,1490
1338,1499,128,63,270,1038,1499
1339,1493,121,61,272,1039,1493
1340,1495,121,66,263,1045,1495
1341,1500,121,68,266,1045,1500
1342,1497,117,75,260,1045,1497
1343,1499,110,81,261,1047,1499
1344,1497,105,77,259,1056,1497
1345,1500,115,69,262,1054,1500
1346,1496,115,63,266,1052,1496
1347,1500,110,60,278,1052,1500
1348,1499,104,64,276,1055,1499
1349,1496,115,62,269,1050,1496
1350,1500,111,71,264,1054,1500
1351,1495,105,65,269,1056,1495
1352,1491,105,64,257,1065,1491
1353,1500,120,59,249,1072,1500
1354,1500,116,54,261,1069,1500
1355,1499,115,61,255,1068,1499
1356,1499,115,65,254,1065,1499
1357,1500,119,71,245,1065,1500
1358,1500,129,59,243,1069,1500
1359,1497,130,57,246,1064,1497
1360,1498,127,58,245,1068,1498
1361,1495,122,71,235,1067,1495
1362,1500,133,74,226,1067,1500
1363,1499,130,65,241,1063,1499
1364,1499,121,78,243,1057,1499
1365,1491,120,75,243,1053,1491
1366,1498,130,65,247,1056,1498
1367,1500,131,64,251,1054,1500
1368,1496,127,64,251,1054,1496
1369,1497,122,68,257,1050,1497
1370,1500,122,73,256,1049,1500
1371,1499,128,71,260,1040,1499
1372,1500,120,71,269,1040,1500
1373,1499,110,73,267,1049,1499
1374,1497,114,71,260,1052,1497
1375,1499,116,72,267,1044,1499
1376,1500,109,67,279,1045,1500
1377,1492,107,61,275,1049,1492
1378,1494,101,69,280,1044,1494
1379,1493,99,74,269,1051,1493
1380,1492,95,72,266,1059,1492
1381,1492,91,68,269,1064,1492
1382,1494,98,61,266,1069,1494
1383,1497,101,57,268,1071,1497
1384,1500,106,58,270,1066,1500
1385,1499,106,57,268,1068,1499
1386,1498,108,61,259,1070,1498
1387,1499,104,64,255,1076,1499
1388,1500,109,62,256,1073,1500
1389,1498,114,63,249,1072,1498
1390,1496,109,61,253,1073,1496
1391,1492,110,55,248,1079,1492
1392,1493,117,62,242,1072,1493
1393,1500,117,64,241,1078,1500
1394,1500,112,63,243,1082,1500
1395,1495,112,64,237,1082,1495
1396,1496,107,67,236,1086,1496
1397,1499,117,62,229,1091,1499
1398,1500,121,58,231,1090,1500
1399,1500,117,60,237,1086,1500
1400,1497,115,59,238,1085,1497
1401,1500,121,59,235,1085,1500
1402,1499,115,58,236,1090,1499
1403,1499,117,58,241,1083,1499
1404,1497,115,59,232,1091,1497
1405,1499,116,60,229,1094,1499
1406,1500,125,62,231,1082,1500
1407,1499,123,64,236,1076,1499
1408,1500,129,62,236,1073,1500
1409,1499,133,66,233,1067,1499
1410,1497,125,72,230,1070,1497
1411,1496,126,64,240,1066,1496
1412,1499,123,76,235,1065,1499
1413,1499,122,75,236,1066,1499
1414,1495,110,81,236,1068,1495
1415,1498,112,80,242,1064,1498
1416,1498,112,71,250,1065,1498
1417,1497,106,69,253,1069,1497
1418,1500,96,66,261,1077,1500
1419,1499,92,69,260,1078,1499
1420,1499,91,67,263,1078,1499
1421,1500,100,63,266,1071,1500
1422,1499,98,65,264,1072,1499
1423,1498,96,63,268,1071,1498
1424,1499,92,64,266,1077,1499
1425,1492,96,52,265,1079,1492
1426,1495,93,56,269,1077,1495
1427,1495,106,64,259,1066,1495
1428,1497,111,61,258,1067,1497
1429,1494,111,57,256,1070,1494
1430,1490,111,61,246,1072,1490
1431,1494,118,56,245,1075,1494
1432,1486,113,58,238,1077,1486
1433,1493,114,64,233,1082,1493
1434,1500,116,59,237,1088,1500
1435,1496,114,61,232,1089,1496
1436,1500,123,59,230,1088,1500
1437,1498,123,62,228,1085,1498
1438,1498,119,52,237,1090,1498
1439,1497,124,54,227,1092,1497
